-- 繁体标志
string_zh_hant = false;

local string_localize = {
	-- 金币单位
	moneyWanStr = "W";
	moneyWanStr2 = [[f]];
	moneyQWStr  = "KW";
	---------------------------------------------------------------
    goldTxStr = "金";
	cancelStr = "取消";
    okStr = "_定";
	returnStr = "返回";
    dialogTitleStr = "剀疤崾";
	yearStr = "年";
	mouthStr = "月";
	dayStr = "日";
    hourStr = "r";
	minStr = "分";
	secStr = "秒";

    keyButtonPrevStr = "上壹";
    keyButtonNextStr = "下壹";
    keyButtonHideStr = "[藏IP";
    keyButtonSendStr = "l送";

    synMoneyFailStr = "金磐步失";
	---------------------------------------------------------------

    feedBackNum = "客服:";
    feedBackEmailTitle = "客服E-mail:";
     feedBackEmailContent = "ddz@boyaa.com ";
    feedBackQQTitle = "玩家交流t:";
	feedBackQQContent = "230972649";

	-- login type
    loginTypeUnloginTxStr = "未登入";
    loginTypeGuestTxStr = "[客用";
    loginTypeFBTxStr = "Facebook";

	-- login
	loginLoadingTextStr = "登中...";
	pleaseLoginStr = "先登";
	loginElsewhereStr = "您的~已在e登，注意~安全，如有疑M客服";
	loginCannotToWifiGame = "o法M入，z查WLANr後重";
	loginStr = "_J";
	nologinStr = "您需要登才能M入[蚺叮";
	networkAnomalyLoginAgain = "您的W路有c}，重新登吧！";
	lackTrumpetStr = "您缺少喇叭";
	isNetworkAvailableStr = "您的W路有c}，z查Wjr后重新吧！";
	loginOnlineNumber = "人正玩";

	-- addition
    ReachedLimitestStr = "本局A取（耗）金帕恳堰_最高限制啦";
    notReachLegalAgeStr = "很抱歉, 由於您未成年,根家定,%s後⒈制下。";
    notRealNameToAuthenticateStr = "很抱歉, 由於您未名JC,根家定,%s後⒈制下线。填JC热";
    oneMinute = "1分";
    fiveMinutes = "5分";
    tenMinutes = "1分";
    threeHours = "3小r";
    notReachLegalAgeStr2 = "由於您未成年，根家<W路[蚬芾盒修k法>定,抱歉要您下了。";
    notRealNameToAuthenticateStr2 = "很抱歉, 由於您未名JC,根家定,⒈制下，填JC热";
    identityNotPassVerifyStr = "您的身份CY]能通^家核，重新C。";
    ReachedLimitestStr2 = "您A取（耗）金帕恳殉今天限制，榱四的健康和a，抱歉要您下了";

	-- addition_input_dialog
    nameAndIDCannotNilStr = "姓名和身份C不能榭";
    idFormatErrorStr = "身份C格式不正_";
    theStateOfYourAuthenticationIS = "恭喜您JC成功，您的JCB";
	adultStr = "成年";
	underAdultStr = "未成年";
	submitingStr = "正在提交";
    dialogTitlePromptStr = "提示";
    dialogContentPromptStr = "根家定，了不被制下，填JC热荩";
    notnow = "r不";
    entrynow = "R上填";

	-- 每日必做
    become_a_vip = "成VIP";
    vip_renewals = "VIPmM";
    reward_value = "+%d";
    dayreward_daycount = "Bm登入%d天";
    vip_day = "有效期%d天";
    cancel_tomorrow_msg = "好，小地主不再打_您了";
    remind_get_ward = "好，明天_始小地主提醒您登入I取睿";
    vip_prerogative = "VIP尊F特";
    vip_buy_introduce = "VIP特啵尊享t名展示，每日~外5000金蓬I取";
    vip_renewals_content = "延享VIP，享特嗖婚g";
    vip_expire_content = "mMVIP，尊享多特";
	daily_sign_activity = "参加活动";

    titleTxStr = "Bm登入";
    msgTxStr1 = "Bm登入%d天";
    msgTxStr2 = " 天了！今日I ";
    noticeTitleTxStr = "钫f明：";

    rewardMoneyTipsStr = "+%d";
    rewardMoneyTipsStr2 = "今天+%d金";
    tomorrowMoneyTipsStr = "明天更多金";
    rewardGiftTitle = [[%d天首充大Y包]];
    remindStartBtnTxStr = "明日提醒";
    remindCancleBtnTxStr = "取消提醒";
    remindCancleStr = "好，小地主不再打_您了";
    remindGetWardStr = "好，明天_始小地主提醒您登入I取睿";
    vipDaysStr = "有效期%d天";

    acPayTxt = "立刻χ";
    acNeedMoneyTxt = "缺金帕耍";
    getMoneyTxt = "快眍I取海量金牛";

    requestGiftRewardStr = "正在I取Y包";
    requestGetDayLoginRewardStr = "正在I取";
    requestGetDayLoginRewardStr2 = "I取Y包";
    dayMoneyGetStr = [[恭喜你@得了Bm登入%d金]];
    dayMoneyGetFailedStr = "I取失";
    dayMoneyGetSucceedStr = "I取成功";

    payConfirmStr = "χ抵校到~後可I取金";
    conditionTextStr = "l件: χ$%s";

    threeTaskStr = "%d鲒A取%d局";
    taskTipMsgStr = "恭喜您完成任眨@得了%d金弄";
    signRuleStr = [[Bm到可I取睿每月一清零重置]];
    signAlreadyStr = "已连续到";
    progressTitleStr = "前BmM度:";
    signTodayBtnStr = "今日到";
    signCompletStr = "今日已到!";
    fillupCardStr = "前a卡:";
    dayCanFillupStr = "月可a:";
    signFillupBtnStr = "a";
    getRewardBtnStr = "立即I取";
    chargeNowBtnStr = "R上χ";
    firstChargeValueStr = "只要%s，即可@r值$%s的大Y包";
    signFillupBuyStr = "I>>";
    dailyTaskActivity = "活";
    dailyTaskSign = "到";

    -- Authcode(验证码)
    inputAuthcodeWrong = "您的Ca有`，重新吧";
    inputWrongAuthcodeExceedLimit = "您的Cae`^多啦，稍候吧";
    authcodeSubmitDataIngStr = "正在提交";
    inputAuthcodeConntNull = "您]有填Ca哦！";

	--cdkey
    cdkeyLicense = "激活aQ";
    cdkeydimension = "二SaQ";
    cdkeyhistory = "Q";
    cdkeyFeedback = "回";
    cdkeyInputLicense = "入激活a :";
    cdkeyInputTip = "Qf明：";
    cdkeyInputTip1 = "1.Q激活a前，先_J您的~;";
    cdkeyInputTip2 = "2.每激活a只能Q1次品;";
    cdkeyInputTip3 = "3.您Q的[虻谰⒃24小r劝l送至您~簦耐心等候！";
    cdkeyExchangeImmediately = "立即Q";
    cdkeyInputVerificate = "入Ca：";
    cdkeyDimensionTip = "⒍SaD案放在呙杩龋即可自呙琛";
    cdkeyTime = "丢rg";
    cdkeyGoodsName = "品";
    cdkeyGoodsState = "l放B";
    cdkeyExchangeSuccess = [[Q成功]];
    reScanBtnStr = [[重新呙]];
    --
    cdkeyCharged = "已χ";
    cdkyeYours = "您的";
    cdkeyMoney = "元M已充入手C";
    cdkeyCheck = "Y，]意查收。";
    cdkeyQuery = "如有疑按以下方式系客服。";
    cdkeyFeedbackTip = "⒛的Q}在下面入框忍提交，客服收到後及r回覆您";
    cdkeyFeedbackTitle = "Q回";
    cdkeyFeedbackInputTip = "入回热...";
    cdkeyFeedbackCommit = "提交回";
    cdkeyInfoName = "收人姓名：";
    cdkeyInfoPhone = "手Ca：";
    cdkeyInfoEmail = "子]箱：";
    cdkeyInfoAdress = "收地址：";
    cdkeyInfoTitle = "系人息";
	cdkeyName = "姓名：";
    cdkeyPhone = "a：";
    cdkeyEmail = "]箱：";
	cdkeyAdress = "地址：";
    cdkeyAttention = "榱四茼利收到您的品，您仔填以下Y";
    cdkeyTip = "剀疤崾荆邯品⒃15工作日劝l放";
    cdkeyCommit = "_J提交";
    cdkeyPhoneInfo = "a息";
    cdkeyLicenseError = "您入的激活a有`，_J後重新入！";
    cdkeyErrorStr = [[入激活a]];
    cdkeyVerificateError = "您的Ca入有`，重新吧！";
    cdkeyRequestLicense = "正在C激活a";
    cdkeyPhoneError = "您的手Ca入有`，正_填！";
    cdkeyAdressError = "需要填您的地址哦";
    cdkeyRequestRecord = "正在求Q";
    hasBeenPaidStr = [[已l放]];
    hasnotBeenPaidStr = [[未l放]];
    notRechargeStr = [[未χ]];
    notRechargeDetailStr = [[您的罴⒊淙胧C:%sY,我⒈M快槟χ,耐心等候]];
    cdkeyHelpStr = [[我⒈M快槟χ,耐心等候]];
    cdkeyWillPaidStr = [[我快寄出您的品，如有疑致客服]];
    cdkeyFeedbackSuccess = [[回蟪晒]];
    cdkey_layout_choose_pic_txt = [[相赃x取]];

	-- http tips
    httpGetRewardTextStr = "正在I取...";
    httpCreatOrderStr = "正在建...";
    httpGetProductStr = "正在@取商品列表，稍後...";
    httpWaitingTxStr = "@取息中...";
    httpCreatOrderWaitingTxStr = "正在提交危稍候...";
    httpRequestMsgStr = "罘峙渲...";

    -- setting
    gold_declare = "金怕明";
    privacy_policy = "[私政策";
    service_agreements = "服fh";
    audioTxStr = "音效";
    musicTxStr = "音";
    silentModeStr = "o音模式";
    balanceStr = "Y算面";
    noviceTipStr = "新手提示";
    shakeStr = "[蛘";
    peelsStr = "Qw:";

    waftStr1 = "前W路B接B良好";
    waftStr2 = "前W路信不定";
    waftStr3 = "前W路信很差";

    wasNewestVersionStr = "前已是最新版本";
    promptSettingBtn = "提示";
    ensureSettingBtn = "_J";
	cancelSettingBtn = "取消";
    ensureToNewestVersionStr = "_J更新到最新版本";
	--------------------------

	-- synmoney
    synMoneySuccStr = "的金盗恳淹步成功！";
    synMoneyFailStr = "同步金攀";
    synMoneyStr = "正在@取金...";
	--------------------------

    -- bankrupt dialog 破b提示
    bankruptTitleStr = "破b提示";
    bankruptGetStr = "破ba助";
    bankruptNoticeStr = "Σ黄鹉已破b，是否I取破ba助？";
    bankruptNoticeStr1 = "Σ黄鹉已破b，您可以通^I[呕蛎魅疹I取登入罾^m[颍";
    bankruptNoticeStr2 = "Σ黄鹉已破b！";
    bankruptNoticeStr3 = "您今天的破aa助金乓呀用完了，快去χ蛋桑";
    bankruptLadingStr = "正在申a助...";
    bankruptSuccStr = "I取破ba助成功，@取";
    bankruptFailStr = "I取破ba助失";
    bankruptMsg = "很z憾，您破a了！";
    bankruptMsg2 = "您破a了，@得%d救金！";
    bankruptMsg3 = "今天的救助已I完";
    bankruptBootMsg = "追";

	-- hall
    hallnoenoughmoneystr = "您需%s金啪湍苓M入,快去χ蒂I金虐!";
    halltoheightroomstr = "去高";
    hallPageItemOnlineNumber = "%s人正玩";
    hallPageItemLimitDescStr = "%s可入";
    hallPageItemNoUppermostStr = "%s以上皆可入";
    hallovermoneytitlestr = "金懦出";
    hallFailToCreatePrivateRoom = "您的金挪蛔悖r不能建房g";
    hallCreateRoom = "建房g";
    hallChooseBaseChip = "x竦鬃(金)";
    hallChooseSingleChip = "x尉州A(金)";
    hallRoomNameTooLong = "房g名Q不能超^16字符哦。";
    hallRoomNamePlease="槟建的房g取名字吧。";
    hallPasswordTip = "密a不能超^10滴唬可不O）。";
    hallNetError = "W路常";
    hallRequestJoinRoom = "正在求M入房g...";
    hallCreatingPrivate = "正在建私人房";
    hallRequestJoinPrivate = "正在M入私人房g";
    hallCheckIn = "正在竺";
    hallCreatePrivateFailed = "很抱歉，建私人房失";
    hallRoomIsFull = "很抱歉，房g玩家已M";
    hallPasswordError = "密ae`";
    hallJoinPrivateFailed = "很抱歉，M入私人房失";
    hallBankruptTip = "您今天的破aa助金乓呀用完了，快去χ蛋桑";
    hallBuyMore = "I更多";
	hallTip = "提醒";
    hallTimeToGameStartYet = "您竺的比，有%d秒_，是否立即M入？";
    hallAddExpressionTip = "再玩%d局即可@得%d的%s升睿";
    hallJoinRoomFailed = "很抱歉，M入房g失。";
    failedToJoinRoomTitle = "入鼋挪蛔";
    failedToJoinRoom = "神，您差%d金胚M入房g";

	--ingot
    ingotNotEnough = "元不足";
    huafeiNotEnught = "M券不足";
    ingotGetIngot = "去元";
    ingotTest = "y";
    ingotGetInfoSuccess = "更新Y成功";
    ingotGetGiftSuccess = "Q成功，品⒃1-2工作日劝l放，耐心等待";
	ingotUpdating = "正在更新...";
    ingotRequesting = "正在求...";
    ingotInputInfoTip = "您可以在Qe面完善您的Y";
    ingotGetSuccess = "I取成功";
    ingotGeting = "正在I取";
    ingotDaysRemind = "剩N%d天";
    ingotGetOnce = "aI";
    ingotPostedYet = "已l";
    ingotRequestingData = "正在求Y料";
    ingotGetOnceSuccess = "aI成功";
    ingotRequestGetOnce = "正在求aI";
    ingotNoGoods = "已锻";
    ingotGoodsPosted = "%s已l";
    ingotNeedNIngot = "需%d元";
    ingotText = "%d元";

    --bet
    betChooseMoney = "x裢对]金~：";
    betWaitingOpen = "正在等待_，稍後操作";
    betLeastMoney = "至少需要%d金挪拍芟略]";
    betMoney = "%d金";
    betRequestBet = "求押";
    betRequestSuccess = "猜猜吠对]成功，扣除%d金";
    betMoneyNotEnough = "金挪蛔悖猜猜房圪M失。本局投]失效";
    betModelNotOpen = "功能未_放";
    betOnceOnly = "局哼^了";
    betCaicaile = "猜猜分歇";
    betMoneyTip = "金";
    betGameTip = "游戏";


	--------------------------
	-- help
	feedOptBtnTxStr = "用艋";
	feedMsgStr = "提交您的F}";
	feedInputMsgStr = "入您的系方式(x填)";
	helpSendSucc = "提交成功，感x您的反！";
	helpSendFail = "很抱歉，提交失。重新吧！";
	addressStr = "系方式";
	noReplyStr = "何椿馗";
	feedMsgErroStr = "信息l送失。z查您的Wj和l送的信息热莞袷健";
	help_feed_layout_photo_tips = "上D片";
	clipQQTips = "已椭QQ到剪N板";
	clipEmailTips = "已椭Email地址到剪N板";

	----------------------------------------------


	-- market
    chargeTxStr = "χ";
    marketTableQueryTxStr = "查 ";
    marketTableGetSuccessTxStr = "I取成功";
	marketFunction = "功能：";
    marketGoldsTipStr = "$1 = %s 金";
    marketPamountStr = "$%s";
    marketPropPriceStr = "r格：%s 金";
    marketBuySuccessStr = "I金奴@得%d金拧";
    marketOrderidStr = "翁：";
    propBuySuccStr = "I%s成功！";
    marketRecordStateStr = "付款_J中";
    marketGetProductSuccStr = "@取商品成功！";
    marketBuyTime = "Irg：";
    marketBuyVIPSuccessStr = "IVIP成功。";
    marketDownload = "下d";
    marketDownloading = "下d中(%d%%)";
	marketNeedToDownloadTip = "H，@表情需要下d後才能使用哦，立刻下d吧！";

    marketFirstBuyTips1 = "您尚未χ担F在χ狄韵氯我饷骖~，即可@得超值Y包！";
    marketFirstBuyTips2 = "每玩家限⑴c一次，Y包即r到ぃ可在人Y谘e查看！";
    roomNotHaveProductStr = "前未@得可I的商品，到商城中使用支付功能";

    alipayStr = "χ";
    smspayStr = "χ";
    unionpayStr = "手Cy";
    recharge_cardStr = "χ悼";
    tenpayStr = "付通";
    mokreditStr = "先玩後付";
    payNoticeStr = "提示：χ的壳H支持部分地^和\I商的用簦解。";
    payPriceStr = "$%.2f";
	creditCardPaystr = "信用卡";
    payconfirmtitlestr = "I提示";

    buySuccess = "I成功";
    ddzTitleStr = "Y地主VIP";
    pay_success = "χ党晒Γl可能存在延t";
    ddzPrivilegeTitleStr = "尊享VIP特";
    mobilePayContentStr = "您⑼ㄟ^的方式I";
    mobilePayMoneyStr = "（等同於%s）";
    mobilePayCancelStr = "您取消了本次χ";
    mobilePayContentStr2 = "不含通M。_J后l送I，返回t不扣M。";
    mobilePaySendSmsStr = "您的I求已提交，系y正在理，I成功后收到扣M提示。部份原因е沦I失。如有疑J客服人T。";
    smsPaySuccessStr = "恭喜您，χ党晒Γ由于网络原因可能存在延迟，我们会尽快为您发货。如有疑J客服人T。";
    confirmToBuyPropStr = "%s只需要%d金排叮是否I？";
    --------------------------

    -- activity
    activityTipStr1 = "o活热";
    activityTipStr2 = "新活蛹㈤_,敬期待";
    -----------------------------------------------------

    --------------------- 人息--------------------------- -------
	boyTextStr = "男生";
	grilTextStr = "女生";
    tsInfoStr1 = "修改人Y成功！";
    tsInfoStr2 = "很抱歉，息上魇....";
    tsInfoStr3 = "填昵Q";
    tsInfoStr4 = "您的昵Q^L";
    updateUserInfoStr = "正在上人Y";
    updateUserInfoStr2 = "正在上人^像...";
    onLoadingStr = "加d中...";
    levelTitle = [[Q:]];
    nickTooLong = [[昵Q字挡荒艹^12字元哦]];
    nickTooShot = [[昵Q字挡荒苌凫3字元哦]];
	-- levelTextStr
	idTextStr = "ID: ";
    userTextStr = "用: ";
    updateHeadImgTextStr = "c粜薷念^像";
    updateHeadImaFailedStr = "很抱歉，上黝^像失。zW路後重新吧！";
    fbTipsTextStr = "剀疤崾荆\n新浪用粽到新浪官W修改人Y";

    ---------- 人息中的vip特嗄K
    becomeVipTipsStr1 = "成VIP玩家可以@得更多特";
    becomeVipStr = "成VIP";
    vipRenewalsStr = "VIPmM";
    vipLevelDescStr = "您差%dc成L值即可升%dT（TS可嘤%d天后到期）";
    vipExpiredDescStr = "您的VIPS可嘁训狡冢值正在倒退中";
    lossOfExperienceStr = "流失中";
    vipShowMorePrivilegeStr = "查看更多VIP特>>";
    myPrivilegeTitleStr = "我的特";
    vipUpgradeStr = "VIP升";

	--------- 进场不足弹窗----------
	vipMonth = "包月";
    vipYear = "年M";
    bankruptRechargeGift = "破aχ蹈剿:";
    rechargeGift = "χ蹈剿:";
    enterRoomNotMoney = "M鼋挪蛔";
    enterLowRoom = "去低倍";
    enterRoomNotMoneyTip = "金挪蛔悖可以x袢サ捅";


	--------- 道具-----------
    volumeStr = "%d①券";
    leftVolumeStr = "剩N%d";
    counterStr = "剩N";
	trumpetStr = [[小喇叭]];
    leftTrumpetStr = [[剩N%d]];
    noPropsStr = [[o道具]];
    fillCardStr = [[a卡]];
    leftFillCardStr = [[剩N%d]];
	noPropsStr = [[o道具]];
    --- 金庞息---
    goldStr = "金牛";
    levelTextStr2 = "等：LV.";
	------------------------------------------------------------

	-- match
    matchovermoneytitlestr = "金懦出";
    matchnoenoughmoneytitlestr = "金挪蛔";
    matchoveringottitlestr = "元超出";
    matchnoenoughmoneystr = "您的金盗坎蛔χ竺M用，快去χ蛋桑";
    matchovermoneystr = "您的金乓殉^本錾舷蓿x衿渌合m①";
    buygoldsstr = "I";
    tolowroomstr = "去低";
    tohightroomstr = "去高";
    duringmatch = "正在比中";
    notenoughmoney = "金挪";
    notenoughplayers = "前①人颠^少，比不得已⒈蝗∠，解！";

    getMatchRewardTipMycard = [[剀疤崾:Mycard钤1~2工作日劝l放]];
    getMatchRewardTipPaypal = [[剀疤崾:Paypal钤1~2工作日劝l放]];
    myCardNum = [[子]箱:]];
    paypalNum = [[paypal~:]];
    confirmTheChanges = [[_J修改]];
    confirmSubmit = [[_J提交]];
    noVolueUseMoneyStr1 = [[①券不足，是否使用金竺？]];
    noVolueUseMoneyStr2 = [[①券不足，是否使用金胚M觯]];
    matchRegistration = [[正在竺]];
    joinMatchRoomStr = [[正在M]];
    joiningMatchRoomStr = [[正在M入比房g]];
    matchWillStartStr = [[比即㈤_始]];
    matchStartStr = [[比正在_]];
    matchFastStr = [[超快]];
    matchAtivityStr = [[活淤]];
    matchAdvaceStr = [[MA]];
    matchQuitTipsStr = [[_定要退出即㈤_始的比？]];
    matchQuitingStr = [[正在求退，稍後]];
    masterScoreNotEnoughStr = [[您的大分不足 ]];
    masterScoretooMoreStr = [[您的大分超^了 ]];
    registrationSuccessStr = [[竺成功]];
    MatchTipsStr1 = [[Tips：楸ＷC公平，比^程不允S聊天]];
    MatchTipsStr2 = [[Tips：超快龃卧礁叩墓谲金弄畋翟礁]];
    MatchTipsStr3 = [[Tips：比中掉，再M牌局仍可^m]];
    MatchTipsStr4 = [[Tips：楸ＷC公平，超快牌局中不能使用牌器]];
    MatchTipsStr5 = [[Tips：建h在Wi-Fi等^定的W路h境下比]];
    MatchTipsStr6 = [[Tips：M入Q後，Ae分按一定tDQe分]];
    MatchTipsStr7 = [[Tips：Q均裼闷迮聘技最公平的“瑞士移位”制]];
    MatchTipsStr8 = [[Tips：槎沤^作弊，我保存比^程中所有]];
    matchRankStr = [[第%d名]];
    rechargeCoins = [[χ到]];
    fastMatchTitle1 = [[金]];
    fastMatchTitle2 = [[f金]];
    championAward = [[冠:]];
    mostAward = [[最高:]];
	at = [[在]];
    inTheApplication = [[正在竺]];
	remind = [[提醒]];
    remindJoinMatch = [[您竺的比，有%d秒_，是否立即M入？]];
    freeApplication = [[免M竺]];
    goldApplication = [[金竺]];
    volumeApplication = [[①券竺]];
    freeJoinMatch = [[免MM]];
    goldJoinMatch = [[金胚M]];
    volumeoinMatch = [[①券M]];
    alreadyStartMatch = [[已_]];
    sometimeStartMatch = [[%s_]];
    matchIsNotOpen = [[比未_]];
    supplementGold = [[a足金]];
	changeAddress = [[修改地址]];
    youGetReward = [[您@得了]];
    advanceMatchRewardTip = [[恭喜您@得前A段]];
    severalMatchRank = [[第%d名]];
    matchBasechipStr = [[在%s底注鲩_]];
    matchAdvanceNameStr = [[pk]];
    MatchRankFisrtTitle = [[恭喜@得冠]];
    MatchRankSecondTitle = [[恭喜@得]];
    MatchRankThirdTitle  = [[恭喜@得季]];
    matchDetailStr = [[
        1.比rg： 每日 %s


        2.①方法： %s 底注SM行[

        3.e分t：
        每局[蚪Y束後所A取金导吹褥侗荣e分担只算正分，了不分。（注：限rY束r，如果正在[蛑校t局得分不入分）

        4.比睿 比Y束后e分排名前30名的玩家可@得相
            第1名， 380,000 金
            第2名， 280,000 金
            第3名， 180,000 金
            第4－10名， 29,000 金
            第11－30名， 19,000 金
        ]];
    matchRewardStr = [[
    比Y束后e分排名前30名的玩家可@得相
    第1名， 380,000 金
    第2名， 280,000 金
    第3名， 180,000 金
    第4－10名， 29,000 金
    第11－30名， 19,000 金
    ]];
    youDontGetReward = [[您r]有@哦，so去打一霰荣吧]];
    rookieMatch = [[新人王x拔]];
    someoneMatch = [[%s]];
    someoneMatch1 = [[%sf]];
	lookOver = [[查看]];
    waitingSecondRound = [[您已被幸\女生x中，自舆M入第2，耐心等待下局_始]];
    waitingNextRound = [[有%d桌未完成的比，休息一下，等待下局比_始。]];
    matchExitTip = [[中途退不有任何睿且在捣昼炔荒茉竺本霰荣，_定要退？]];
    matchwaitingTip1 = "Tips：楸ＷC事公平，比牌局不允S聊天";
    matchwaitingTip2 = "Tips：超快越高龃蔚墓谲畋翟礁";
    matchwaitingTip3 = "Tips：比中掉，再M[蜻可以^m";
    matchwaitingTip4 = "Tips：楸ＷC公平，超快牌局中^不出F牌器";
    matchwaitingTip5 = "Tips：建h用Wi-Fi等^榉定的W路⒓颖荣";
    matchwaitingTip6 = "Tips：MQ後，Ae分按一定的算法De分";
    matchwaitingTip7 = "Tips：QA段均裼闷迮聘技最公平的“瑞士移位”制";
    matchwaitingTip8 = "Tips：槎沤^作弊，我在毂４嫠有比的";
    matchwaitingTip9 = "Tips：①券畎l放可能出F延t，建h您重新登入刷新查看";
    matchExitSuccess = [[退出比成功]];
    matchNotExit = [[不能退出比]];
    finalDonotExit = [[Q不能退出]];
    matchPunishment = [[F在退意味著放最K睿且捣昼不能再竺，您_定退幔]];
    matchPunishmentOK = [[退]];
    matchPunishmentCancel = [[^m比]];
    primaryMatch = [[A]];
    finalMatch = [[Q]];
    serverMatchSet = [[第%d]];
    serverMatchPercentSet = [[第%d/%d]];
	serverMatchNumber = [[第%d局]];
    matchBegin = [[正式_始]];
    currentRoundLowScoreEliminate = [[本Y束e分低於 %d 分⒈惶蕴]];
    currentRoundLastThreeEliminate = [[本Y束前3名之後的玩家⒈惶蕴]];
    currentRoundTopThree = [[本Y束⑦x出前3名]];
    activityMatchStr = [[Y地主活淤]];
    advanceMatchStr = [[Y地主MA]];
    currentScore = [[前e分]];
    matchLastTime = [[剩Nrg %s]];
    currentScoreAndRank = [[前e分%d   第%d名]];
    earningcoinszone = [[金刨^]];
    realrewardzone = [[A大^]];
    masterscorezone = [[大分^]];
    realrewardzoneDesc = [[海量①卷、大分，每天准c等你碲A取！]];
    masterscorezoneDesc = [[享受多人技，大分彰@su，g迎高手挑穑]];
    earningcoinszoneDesc = [[O速_，o需等待，金哦喽啵p@得！]];
    noMatchReward = [[o]];
    matchgetcarrewardstrpaypal = "您的钜χ抵Paypal~%sY，注意查收！如有疑按以下方式系客服。";
    matchreadygetcarrewardstrpaypal = "您的罴χ抵Paypal~%sY，等待核！如有疑，按以下方式系客服。";
    matchreadygetcarrewarderrostrpaypal = "您]有Paypal~簦o法I取睿按以下方式系客服。";

    matchgetcarrewardstrmycard = "您的Mycardc悼ㄒ寻l送至子~%sY，注意查收！如有疑按以下方式系客服。";
    matchreadygetcarrewardstrmycard = "您的Mycardc悼即l送至子~%sY，等待核！如有疑，按以下方式系客服。";
    matchreadygetcarrewarderrostrmycard = "您]有入子~簦o法I取睿按以下方式系客服。";

    examineing = "正在核";
    examined = "已核";
	hassendstr = "已寄出";
    sendingstr = "即⒓某";
    matchponeerrostr = "您入的a不正_";
    matchreceivestr = "I取%s";
    matchnameerrostr = "姓名不能空";
    matchphoneemptystr = "a不能空";
    matchphoneerrostr = "a不正_";
    matchmailerrostr = "]箱地址不能空";
    matchaddrerrostr = "l地址不能空";

    advanceMatchTipStr = "您已@得本A段的睿是否以此竺下一A段？";
    nextadvancematchreward = "下A段的冠:";
    gotonextadvancematch = "去下一A段";
    nextadvancematchNeedMoney = "竺需要%d金";
	matchRewardHadSend = "您所获得虚拟奖励已发放哦";

    matchRewardSuccess = "恭喜您I取了%d金弄睿";
    matchRewardFail = "I取失。重新再";
    matchRewardHadSend = "您所@得的M钜呀l放哦";


	-- 私人房
    privatenoenoughmoneytocreatstr = "金挪蛔%d，o法建私人房";
    privatekickedbyowner = "您已被房主x房g，x衿渌房g[颉";
    privatekickedbyserver = "您因Lrg未准湟央x_[蚍块g，重新M入。";

    ---------------------------------------- 比start
    fastMatchStr = "Y地主超快";
    fastMatchTipsStr = "Y地主超快火衢_，海量金诺碲A";

    ---------------------------------------- 比 end

    ---------------------------------------- 元商城start----------------------------------------
    callsAwardStr = [[的钜呀充入手C%s, 注意查收!]];
    shippedStr = [[%s已l]];
    modifyInformation = [[修改息]];
    updateInfoSuccessStr = [[更新息成功]];
    ---------------------------------------- 元商城 end----------------------------------------

	--------------------- 排行榜 start--------------------------- -------
	withoutEntryStr = "未入榜";
	rankStr = "第%d名";
    goToMacthStr = "去比";
    goToActiveStr = "⒓踊";
    goToActiveStr = "⒓踊";
    actTimeStr = "活rg";
    gameTopLoadingStr1 = "加d材富榜";
    gameTopLoadingStr2 = "加d昨日金榜";
    gameTopLoadingStr3 = "加d昨日χ蛋";
    gameTopLoadingStr4 = "加d冠榜";

    todayAssetsStr = "今日Ya: ";
    yesterdayAssetsStr = "昨日Yb: ";
    yesterdayEarnGoldStr = "昨日金: ";
    yesterdayRechargeStr = "昨日χ: ";
    championRankStr1 = "冠次: ";
    championRankStr2 = "次: ";
    championRankStr3 = "季次: ";

	--------------------- 排行榜 end--------------------------- -------

	----------------------- 举报start---------------------------------
    reportTextStr = "e蟪晒Γ我快理";
    reportNumStr = "今日e蟠狄M";
    haveReportedStr = "您已e筮^玩家，我快理";
	unReasonStr = "未知原因";
    reportReasonStr = "e笤因";
    reportCommandStr = "您的e笮畔⑽已收到，我快理您的求";
	----------------------- 举报end-----------------------------------

    --------------------- 任障到ystart--------------------------- -------
    completeTheTaskStr = "恭喜您完成任眨@得了%s金拧";
    haveBeenIssuedStr = "已I取";
    taskRewardStr = ": ";
    taskRewardFailStr = "@取任摘钍";
    requestTaskRewardStr = "正在@取任摘";
    taskRewardTipsStr = "任摘:";
    doTaskStr = "做任";
    getTaskFail = "@取任帐。重新登入[";

	-- room
	defaultTimeStr = "00:00:00";
    grablordplusone = "每一次地主，r民被牌+1";
    room_task_reward = "您需要W[虿拍荛_箱!";
    -- 快捷χ
    quick_buy_text = "特rN售，%d金胖恍%d元，不快";
    quick_buy_name = "%s金";
    quick_buy_price = "￥:%.2f";

    readyBtnTxStr = "";
    changeTableBtnTxStr = "Q桌";
    callScore0BtnTxStr = "不叫";
    callScore1BtnTxStr = "1分";
    callScore2BtnTxStr = "2分";
    callScore3BtnTxStr = "3分";
    call0BtnTxStr = "不叫";
    call1BtnTxStr = "叫地主";
    call2BtnTxStr = "不";
    call3BtnTxStr = "地主";
    double_btn_str = "加倍";
    no_double_btn_str = "不加倍";

    noOutCardBtnTxStr = "不出";
    resetCardBtnTxStr = "重x";
    tipsCardBtnTxStr = "提示";
    outCardBtnTxStr = "出牌";
    chestRewardStr = "I取";
    checkRewardStr = "查看";
    chestTimeLackStr = "rg不足，o法_箱";
    chestOpenBoxFailStr = "_箱失";
    chestRewardSuccStr = "恭喜您,您_箱@得";
    moneyLack1 = "您的金乓殉^本房g上限";
    moneyLack2 = "，您移步到更高的[!";
    moneyNotEnough1 = "您的金挪蛔";
    moneyNotEnough2 = "，您移步到其他[觯";
    moneyNil = "您的金挪蛔悖及rχ担";
    readyTs = "c糇浒粹o";
	roomTsStr1 = "正在配桌中...";
    labaTsStr = "在O定中,可以更Q桌面皮w！";
    roomTsStr2 = "前oV播息";
    roomTsStr3 = "Lrg未准浔惶叱龇块g";

    currentNoBroadCast = [[r]有V播息]];
    roomTrusteeFail = "o法托管";
    roomovergomegoldstr = "前底注鲒A取%d局可@得元，A取M度%d/%d";
    congoldget = "恭喜您@得%d元，可以在元商城Q物";
    --player_info
    roomWinText = "";
    roomLostText = "";

    -------------------------- bet 押
    betLimitTextStr = "至少需要%d金挪拍芟伦";
    buyCancleTextStr = "取消投注";
    buyEveryTextStr = "投注每局";
    boughtEveryTextStr = "已投注每局";
    buyNextTextStr = "投注下局";
    boughtNextTextStr = "已投注下局";
    cancleEveryTextStr = "取消投注每局";
    betDeclare = "[蚵明：[蛑惺褂玫降倪[蚪诺染[虻谰撸不具有任何b性功能，只限用舯救嗽谶[蛑惺褂茫槐具[τ谟羲碛械倪[蚪挪惶峁┤魏涡问降墓俜交刭、直接或相QF金或物，相互予D等服占跋嚓P功能；本[澜用糁g在[蛑屑熬下M行任何相互叫u、D[诺刃，如壹查出t永久封，~羟辶恪";
    betExplain = "投注猜猜丰幔只要在打牌_始r拿到中牌型，就能@得大。如果同r拿到多N中牌型，t可I取各牌型的中金~之和。\n注意事：\n1.如果局牌出F因不叫地主多次l牌的情r，押中的判定只以第1次l出的牌准。\n2.[蜃淝埃 可以x裢蹲⑾戮只蛲蹲⒃诖朔块g每局的猜猜贰 \n投注M用在下/每局_始r扣取。如果x_房g，投注B失效。\n3.中@得的金=投注M用xr率。每日r率可能不同，以I取r的r率准";
    -------------------------- bet 押end

    --toolBar
    botTipStr = "托管";
    logooutTipStr = "退出";
    setTipStr = "O定";
    chatTipStr = "聊天";
    moreTipStr = "更多";
    faceTipStr = "表情";
    anteStr = "底注:";
    multipleStr = "倍:";
    waftTipStr = "信";

	-- room chat
    faceBTextStr = "B表情";
    faceMTextStr = "M表情";
    faceQTextStr = "Q表情";
    faceTipStr2 = "剀疤崾荆C免Mw牌器哦";
    faceTipStr3 = "剀疤崾荆豪mMVIP可以^m使用";
    faceTipStr4 = "剀疤崾荆河行期剩N%d";
    faceTipStr5 = "VIP用艨梢悦赓M使用表情";
    faceTipStr6 = "剀疤崾荆涸表情需要I";
    faceTipStr7 = [[您可以在人信息我的道具I]];
    faceTipStr8 = "剀疤崾荆耗曩Mvip用裘赓M使用";
    faceTipStr9 = "剀疤崾荆C免Mw表情包哦";
	faceTipStrEnd = "天";
    labaTipStr1 = "您]有喇叭，o法l送V播息，至商城I";
    labaTipStr2 = "您⑾耗1喇叭，l送V播息";
    editTipStr1 = "入聊天息";
    editTipStr2 = "入V播消息";
    editTipStr3 = "四人r只允Sl表情和常用Z";
    editTipStr4 = "本龃H支持l送喇叭息";
    editTipStr5 = "您入的信息^L,最L32h字,重新入。";
    labaTipStr3 = "了保C公平的[颦h境,本r不支持房g聊天";
    labaTipStr4 = "C或wifi翰恢С职l送喇叭";



    sysChatText1 = "快c吧，我等的花憾贾x了！";
	sysChatText2 = "你的牌打的太好了！";
	sysChatText3 = "和你合作真的是太愉快啦！";
    sysChatText4 = "吐了槽的，整一杯具啊！";
    sysChatText5 = "怎N炸@N多，我都被炸了@.@";
    sysChatText6 = "哎...一手牌臭到底。";
    -- sysChatText7 = "不怕神一拥κ郑就怕i一拥年友。";
    sysChatText7 = "投降一半，速度投降吧！";
    sysChatText8 = "不要吵了，有什N好吵的，Ｐ耐媾瓢桑";
    sysChatText9 = "大清早的，u都]叫，慌什N嘛？";


	---------- room vip kickout ----------
    vipKictoutStr1 = [[您成功使用踢人功能，玩家%s被踢出房g]];
    vipKictoutStr2 = [[您被VIP玩家%sx了房g]];
    vipKictoutStr3 = [[[蚪Y束后玩家⒈惶叱龇块g]];
    vipKictoutStr4 = [[您不能VIP玩家使用踢人功能]];
    vipKictoutStr5 = [[您不能对更高VIP玩家使用踢人功能]];
    vipKictoutStr6 = [[成VIP才能使用踢人功能]];
	--------------------------------------
	-- pay
    payNosupportCurPmodeStr = "翰恢гχ捣绞剑x衿渌χ捣绞健";
    payCreatOrderWaitingTxStr = "提交沃校稍候...";
    payCheckSimStr = "z您的SIM卡";
    paySmsLimiteStr = "χ到痤~已_到上限，x衿渌χ捣绞健";
    payshortcutnosupport = "房gH支持快捷χ担到商城x衿渌χ捣绞";
    payshortcutnosupporttelecom = "房gH支持信用艉快捷χ担到商城x衿渌χ捣绞";
    payrequestroompay = "正在求χ...";
    paynosupportstr = "翰χ%d元以上的商品χ怠";
    paysmsotherpaystr = "商品翰恢С趾χ担x衿渌χ捣绞健";
    paysmsSelMobileCardStr = "前版本r只支持中移佑χ担使用中移邮C卡M行I。";
    not_short_pay = "[蛑校翰恢С挚旖χ";

	-- feed
    feedNoticeStr1 = "恭喜分享成功";
    feedNoticeStr2 = "分享失";

    share_start_str = "正在l送分享";

    share_succ_spring = "我在#博雅Y地主#中打出壹手漂亮的春天，牌技在是高！快硪计痿Y地主吧！";
	share_succ_spring_url = "http://m.boyaa.com/click.php?c=1&l=1&a=11";

    share_succ_hight_ant = "我在#博雅Y地主#中打出了 %d 倍，A了 %d 金牛爽翻了！快硪计痿Y地主吧！";
	share_succ_hight_ant_url = "http://m.boyaa.com/click.php?c=1&l=1&a=11";

    share_succ_farmer = "我在#博雅Y地主#中把地主推倒了，壹次了 %d 金牛√爽了！砗臀乙计鹜姘桑";
	share_succ_farmer_url = "http://m.boyaa.com/click.php?c=1&l=1&a=11";

    share_succ_landlord = "我正在#博雅Y地主#中欺恨r民，壹次就 %d 金牛太爽了！砗臀乙计鹜姘桑";
	share_succ_landlord_url = "http://m.boyaa.com/click.php?c=1&l=1&a=11";

    share_fail_spring = "我在#博雅Y地主#中被κ执虺隽舜禾欤\庹媸翘背了，Ψ揭级ㄊ谴焊绺襟w了！";
	share_fail_spring_url = "http://m.boyaa.com/click.php?c=1&l=1&a=11";

    share_fail_hight_ant = "我在#博雅Y地主#中打出了 %d 倍，但A家不是我，p失了我 %d 金牛";
	share_fail_hight_ant_url = "http://m.boyaa.com/click.php?c=1&l=1&a=11";

    share_fail_farmer = "我在#博雅Y地主#中被地主打倒了，壹次了 %d 金牛√坑爹了！快臀野桑";
	share_fail_farmer_url = "http://m.boyaa.com/click.php?c=1&l=1&a=11";

    share_fail_landlord = "我正在#博雅Y地主#中被r民推倒了，壹次就了 %d 金牛K了！o急呼叫部支援！";
	share_fail_landlord_url = "http://m.boyaa.com/click.php?c=1&l=1&a=11";

    share_match_winner = "我在#博雅Y地主#比中^黾穑最K孬@冠、傲群雄。有本事就硖鹞业耐踝吧！";
	share_match_winner_url = "http://m.boyaa.com/click.php?c=1&l=1&a=11";

    share_match_other = "我在#博雅Y地主#比中^黾穑最K孬@第%d名的鹂。壹起碜す谲的s耀吧！";
	share_match_other_url = "http://m.boyaa.com/click.php?c=1&l=1&a=11";

	-- add start laiwenyuan 2013/6/21 --
	-- 微信分享
	share_normal_title1 = "哇哈哈，pp松松打出%d倍，小夥伴快硖鹞野桑";
	share_normal_title2 = "壹局打出%d倍，我和我的小夥伴都@呆了！等什麽快硖鹞野桑";
	share_match_first_title = "s耀的p峰已在我_下，想要享受壹[山小的感X麽，博雅Y地主，等硗妫";
	share_match_second_title = "s耀已在我手，S厚Y品我也有，小夥伴博雅Y地主，等硗妫";
    share_match_third_title = "我已踏Ms耀的殿堂，刺激、好玩的博雅Y地主柱等硗妫";
	share_exchange_title = "哇！我用元Q@得%s睢２┭鹏Y地主，S厚的物畹砟茫";
	share_text_needed = "您]有入分享文字";
	share_success = "分享成功";
	share_get_reward = "I取成功：%d金";
	share_get_reward_failure = "I取失";
	share_already_got_reward = "已I取";
    share_already_got_reward_info = "分享成功，已@%d金拧";
	share_reward_can_get_reward = "I取";
    share_reward_can_get_reward_info = "分享成功，送%d金拧";
    share_reward_not_shared_yet = "分享鹂，即可@%d金拧";

    wx_share_common = "z禾日午，股票不靠V，eo事做，#博雅Y地主#！H，今天和好友Y了幔";

	---------------------------------------------- gamesocket----start------------
    socketJoinRoomFailedStr = "M入房g失";
    socketMoneyOverStr = "金胚^多";
    socketMasterToMore = "您的大分等^高，x衿渌龃芜M行比";
    socketMasterToLess = "您的大分等不足，x衿渌龃芜M行比";
    socketGoOutStr = "比中途退，等待下次C";
    socketMoneyLessStr = "金挪蛔";
    socketSessionKeyErrorStr = "用趄Ce`，建h返回登重新登[颍";
    youBankruptTips = "y以置信，您居然破a了";

    socketEnrollFailedStr = "竺失";
    socketNotMatchRoom = "比霾淮嬖";
    socketHasEnrolled = "已筮^名了";
    socketFullPeople = "人狄M";
    socketNotEnroll = "]有竺";
    socketJoinPropleFull = "⒓尤狄M";
    socketNotLotteries = "]有券";
    socketNotStart = "竺尚未_始";
    socketWaitNextOne = "等待下次比_始";
    socketExitFail = "o法退出比";
    socketUserNotFull = "人挡颍o法M行比";
    socketServerError = "服掌麇e`，o法M行比";
    socketExitSuccess = "退成功";
    socketJoinSuccess = "竺成功，在_前M入";

	---------------------------------------------- gamesocket----end------------

    ------------------------ e`息------------------------ ----
    strError1 = "W路B接失。zW路r後重";
    strError2 = "系y]有成功@取l牌担抱歉需要您退出房g";
    strError3 = "系y]有成功@取使用者Y，抱歉需要您退出房g";
    strError4 = "因系y@取您的座位失。抱歉需要您退出房g";
    strError5 = "我的座位@取失,退出房g";
    strError6 = "您的W路已中";
    strError7 = "登入失,其他e`,err=";
    strError8 = "登入失,table_id=";
    strError9 = "登入失,X不 ";
    strError10 = "登入失,err=";
    strError11 = "V播和７";
    strError12 = "未知e`,找不到e`a";

    strError13 = "重Be`";
    strError14 = "~糁匮}登入";
    strError15 = "keye`";
    strError16 = "MYSQLe`";
    strError17 = "桌子不存在";
    strError18 = "用暨M入不同的桌子";
    strError19 = "求房g人M";
    strError20 = "房g]有空座位";
    strError21 = "很抱歉,您的金挪蛔憷玻";
    strError22 = "@取房g息失";
    strError23 = "[蚱陂g,不能退出房g";
    strError24 = "填昵Q";
    strError25 = "求W路靛e`";
    strError27 = "W路B接失。重B中...";
    strError28 = "W路B接失。zW路r後重新登入吧。";
    strError29 = "W路求常，稍後再！";
    strError30 = "W路B接超r，zW路r後重";
    strError31 = "您的Ya已超^本錾舷蓿去高倍鐾喊桑";
    strError32 = "您的金懦霈F常，求c服掌魍步";
    strError33 = "登入失。zW路r後重！";
    strError34 = "您的W路常，需要重新M入[蚍块g！";
    leaveRoomTips="正在退出房g，稍等...";

    errorTitleTextStr = "程式出e啦........";
    errorStrTextStr = "出e原因: ";
    returnButTextStr = "重新舆[";
    errorReportTextStr = "非常抱歉，lF常e`，[o法正常^m，重新舆[颉ＮR上理}，感x您的支持！";

	-------------------------------------------- new ----------------------------------
    activityTipStr1 = "o活热";
    activityTipStr2 = "新活蛹㈤_,敬期待";
    chestTips1 = "正在M行";
    chestTips2 = "免MI取";
    chestTips3 = "已I取";

    --------------------- 玩家等--------------------------- -------
    strLevel1 = "幼稚@1年";
    strLevel2 = "幼稚@2年";
    strLevel3 = "幼稚@3年";
    strLevel4 = "小W1年";
    strLevel5 = "小W2年";
    strLevel6 = "小W3年";
    strLevel7 = "小W4年";
    strLevel8 = "小W5年";
    strLevel9 = "小W6年";
    strLevel10 = "初中W1年";
    strLevel11 = "初中W2年";
    strLevel12 = "初中W3年";
    strLevel13 = "高中W1年";
    strLevel14 = "高中W2年";
    strLevel15 = "高中W3年";
    strLevel16 = "大WA科1年";
    strLevel17 = "大WA科2年";
    strLevel18 = "大WA科3年";
    strLevel19 = "大W1年";
    strLevel20 = "大W2年";
    strLevel21 = "大W3年";
    strLevel22 = "大W4年";
    strLevel23 = "研究生1年";
    strLevel24 = "研究生2年";
    strLevel25 = "研究生3年";
    strLevel26 = "博士1年";
    strLevel27 = "博士2年";
    strLevel28 = "博士3年";
    strLevel29 = "博士後1年";
    strLevel30 = "博士後2年";
    strLevel31 = "博士後3年";
    strLevel32 = "v初";
    strLevel33 = "v中";
    strLevel34 = "v高";
    strLevel35 = "v初";
    strLevel36 = "v中";
    strLevel37 = "v高";
    strLevel38 = "初";
    strLevel39 = "中";
    strLevel40 = "高";
    strLevel41 = "副教е魅";
    strLevel42 = "教е魅";
    strLevel43 = "副校L";
    strLevel44 = "校L";
    strLevel45 = "教育局副局L";
    strLevel46 = "教育局局L";
    strLevel47 = "教育d副dL";
    strLevel48 = "教育副dL";
    strLevel49 = "教育部副部L";
    strLevel50 = "教育部部L";
    strLexp1 = "0";
    strLexp2 = "5";
    strLexp3 = "35";
    strLexp4 = "75";
    strLexp5 = "135";
    strLexp6 = "235";
    strLexp7 = "387";
    strLexp8 = "591";
    strLexp9 = "847";
    strLexp10 = "1155";
    strLexp11 = "1515";
    strLexp12 = "1927";
    strLexp13 = "2391";
    strLexp14 = "2907";
    strLexp15 = "3475";
    strLexp16 = "4095";
    strLexp17 = "4767";
    strLexp18 = "5491";
    strLexp19 = "6267";
    strLexp20 = "7095";
    strLexp21 = "7975";
    strLexp22 = "8907";
    strLexp23 = "9891";
    strLexp24 = "10927";
    strLexp25 = "12015";
    strLexp26 = "13155";
    strLexp27 = "14347";
    strLexp28 = "15591";
    strLexp29 = "16887";
    strLexp30 = "18235";
    strLexp31 = "19635";
    strLexp32 = "21087";
    strLexp33 = "22591";
    strLexp34 = "24147";
    strLexp35 = "25755";
    strLexp36 = "27415";
    strLexp37 = "29127";
    strLexp38 = "30891";
    strLexp39 = "32707";
    strLexp40 = "34575";
    strLexp41 = "36495";
    strLexp42 = "38467";
    strLexp43 = "40491";
    strLexp44 = "42567";
    strLexp45 = "134085";
    strLexp46 = "187500";
    strLexp47 = "245535";
    strLexp48 = "308346";
    strLexp49 = "429816";
    strLexp50 = "685035";
	------------------------ 房间等级
    newRoom = "新手";
    primaryRoom = "初";
    middleRoom = "中";
    highRoom = "高";
    highRandomRoom = "高手SC";
    masterRandomRoom = "大SC";
    dushenzhengbaRoom = "神SC";
    dianfengduijueRoom = "p峰Q";
    visibleCardsRoom = "明牌w";

    ddz4NewRoom = "四人新手";
    ddz4PrimaryRoom = "四人初";

    bugNewRoom = "]子新手";
    bugPrimaryRoom = "癞子初级";


    --loading面中的tips
    loadingTipTxStr01 = "什麽是炸？\r\n炸：四至五同抵蹬瞥火箭和比自己大的炸外，什麽牌型都可打。\r\n例如：3333或44444";
    loadingTipTxStr02 = "炸越多，翻倍越多幔\r\n×2倍：普通炸、火箭、乘2倍。×3倍：天尊和天炸乘3倍。";
    loadingTipTxStr03 = "最大的炸是什麽？\r\n天尊：即四王(四鬼牌)，什麽牌型都可打，是最大的牌型。";
    loadingTipTxStr04 = "翻倍有限制幔孔疃嗄芊多少倍？\r\n翻倍：[]有Ψ倍做限制，打出多少炸，就能翻多少倍。目前y人T最高o是4608倍。";
    loadingTipTxStr05 = "怎麽@得免M金牛\r\n金牛⒓踊雍屯瓿扇湛梢垣@得大量的免M金牛此外得每天I取免M的登睢";
    loadingTipTxStr06 = "@[蚝馁M流量幔\r\n流量：不用心流量，目前yY果1小r之韧瓿20局，150kb的流量。";
    loadingTipTxStr07 = "p王不是炸幔\r\np王：相同的王只能ψ优菩停相同的大王（大鬼）是最大的ψ优菩汀";
    loadingTipTxStr08 = "活又行氖亲鍪谗岬模\r\n活樱哼[不定期_展各的活樱可以在活又行难Y⒓右悠教ǖ乃娜唆Y地主[蚧印";
    loadingTipTxStr09 = "@麽多[鲇惺谗岵煌？\r\n[觯焊叩燃鲅Y往往是牌技高超的玩家，如果有更多的金牛那就去高龊退切磋牌技吧。 ";
    loadingTipTxStr10 = "掉了怎麽k？\r\n托管：玩家因W路原因掉，或者其他原因x_[r，[蜃愚DC器人托管，K不影所在牌局的正常M行。";



    roomGameOverTotal = "总共 %d 倍";
    roomGameOverBaseChips1 = "底注：%d";
    roomGameOverEarn = "您A了";
    roomGameOverLose = "您了";
    roomGameOverGold = "金";
    pauseStr = "和Ｖ..";

    string_task_last_card = "最後出牌:";
	string_task_down_card = "底牌:";

	string_task_last_card_type = {
      "A取金拧",
      "",
      "ψ",
      "子",
      "三",
      "wC",
      "炸",
      "p王",
	};

	string_task_down_card_type = {
      "A取金拧",
      "o",
      "喂",
      "壹",
      "子",
      "三l",
      "同花",
      "p王",
		"同花",
	};
    string_task_not_exist = "o";
    string_task_down_not_exist = "底牌:o";
    string_task_last_not_exist = "最後手牌:o";

    singleContinueDialogTitleStr = "^m[";
    singleContinueDialogMsgStr = "是否^m之前未Y束的牌局？";
    singleContinueDialogContinueStr = "^m";
    singleContinueDialogRestartStr = "重新_始";


    matchRoomMasterScoreTip = "     大分是事su的象徵，也是⒓痈呒的必要l件，只有在比中@得^高名次的玩家才能得到。您的大分分e_到1k和10kr，您在比龅念^像也⒆椤熬英”或“大”!";

	----------------------- svip---------------------
    svipNoNameStr = "您]有填名字哦，完善后提交，感x！";
    svipNoBirthdayStr = "您]有填生日哦，完善后提交，感x！";
    svipNoPhoneStr = "您]有填a哦，完善后提交，感x！";
    svipNoAddrStr = "您]有填地址哦，完善后提交，感x！";
    svipPhoneGeshiStr = "您的a格式不正_，完善后提交，感x！";
    svipEmailGeshiStr = "您的]箱地址格式不正_，请完善后提交，感谢！";
	svipWeixin = "微信";
	svipSinaWeibo = "新浪微博";
    svipTencentWeibo = "v微博";
	svipOther = "其他";
    svipSubmitting = "正在提交";
    svipBirthdayGift = "生日Y物";
    svipBirthdayGiftInfo = "生日r刻，小地主槟砩衩刈８";
    svipSpecialCare = "特殊P";
    svipSpecialCareInfo = "小地主每r每刻槟惬I上更N心的服";
    svipNoblePrivilege = "尊F特";
    svipNoblePrivilegeInfo = "尊F反先行等等SVIP尊F特";
	svipMore = "更多精彩";
    svipMoreInfo = "充值特唷⒒犹啵更多精彩敬期待";

    ----------- 玩法f明
    descSingleCard = [[闻]];
    descSingleCardCompare = [[闻瓢捶种当容^大小，依次是:]];
    descSingleCardCompare2 = [[大王>小王>2>A>k>Q>J>10>9>8>7>6>5>4>3]];
    descDoubleCard = [[ψ:]];
    descDoubleCardDesc = [[任意c迪嗤的牌:]];
    descDoubleLine = [[B:]];
    descDoubleLineDesc = [[三或三σ陨宵c迪噙B的牌]];
    descThreeCardTitle = [[三:]];
    descThreeCardDesc = [[任意三c迪嗤的牌:]];
    descThreeTakeTwoCardTitle = [[三Ф:]];
    descThreeTakeTwoCardDesc = [[c迪嗤的三牌+一ε]];
    descOnelineTitle = [[子:]];
    descOnelineDesc = [[任意五或者五以上c迪噙B的牌]];
    descAirPlayTitle = [[wC:]];
    descAirPlayDesc = [[山M或山M以上c迪噙B的三牌]];
    descBombTitle = [[炸:]];
    descBombDesc = [[四，五或者六相同的牌]];
    descBomb2Title = [[:]];
    descBomb2Desc = [[七相同的牌]];
    descBomb3Title = [[天炸:]];
    descBomb3Desc = [[八c迪嗤的牌]];
    descBomb4Title = [[天尊:]];
    descBomb4Desc = [[四王牌]];


    laiziTitle1 = [[]子牌:]];
    laiziDesc1 = [[可以通用的f能牌(不能用作大小王),可c其他牌搭配]];
    laiziDesc1_2 = [[M成任意牌型,但为打出r只能作槠浔旧硎褂]];

    laiziTitle2 = [[炸:]];
    laiziDesc2 = [[由]子牌和非]子牌M成的炸:]];

    laiziTitle3 = [[硬炸:]];
    laiziDesc3 = [[四同抵刀非]子M成的炸]];

    laiziTitle4 = [[]子炸:]];
    laiziDesc4 = [[四]子M成的炸:]];

    laiziTitle5 = [[炸大小比^:]];
    laiziDesc5 = [[火箭(大小王)>]子炸>硬炸>炸]];
    ----------- 玩法f明

    matchRoomMasterScoreTip = "     大分是事su的象征，也是⒓痈呒事的必要l件，只有在比中@得^高名次的玩家才能得到。您的大分分e_到1k和10kr，您在比龅念^像框也⒆“精英”或“大”!";

    layout_match_delivery_dialog_title = [[I取 Iphone5]];
    layout_match_delivery_dialog_name = [[收人姓名：]];
    layout_match_delivery_dialog_phone = [[手Ca：]];
    layout_match_delivery_dialog_email = [[子]件：]];
    layout_match_delivery_dialog_address = [[收地址：]];
    layout_match_delivery_dialog_modify_tx = [[修改地址]];
    layout_match_delivery_dialog_reward_tx = [[_JI取]];
    login_select_fragment_visitor_tx = [[[客登入]];

    billboard_layout_backBtnText = [[返回]];
    billboard_layout_wealthBtnTx = [[富榜]];
    billboard_layout_gainBtnTx = [[昨日金榜]];
    billboard_layout_rechargeBtnTx = [[昨日χ蛋]];
    billboard_layout_championBtnTx = [[超快冠榜]];
    billboard_item_layout_rankText = [[未入榜]];
    billboard_item_layout_rankMsg = [[昨日χ:]];
    billboard_item_layout_userName = [[工程F]];
    billboard_layout_toMarketBtnTx = [[χ]];
    billboard_layout_backTopBtnTx = [[回到部]];
    billboard_layout_toMatchBtnTx = [[去比]];

    ingot_task_item_layout_title = [[3人1000底]]];
    ingot_task_item_layout_desc = [[3人1000底]]];
    layout_golds_item_view_title = [[200,00金]];
    layout_golds_item_view_subtitle = [[r：￥1=6666金]];
    layout_golds_item_view_price = [[r格：￥30]];
    layout_golds_item_view_buytx = [[I]];
    hall_private_page_layout_btn_refresh_text = [[刷  新]];
    hall_private_page_layout_btn_totop_text = [[回到端]];
    layout_chest_chestLastTx = [[剩余rg：]];
    layout_chest_taskTx1 = [[20地主A取10局]];
    layout_chest_taskTx2 = [[20底]25局]];
    layout_chest_chestLastTimeTx = [[00:00]];
    layout_chest_chestBtnTx = [[正在M行]];
    layout_chest_task1BtnTx = [[正在M行]];
    layout_chest_task2BtnTx = [[正在M行]];
    room_score3_button_layout_three_point_txt = [[3 分]];
    hall_page_yuanbao_item_layout_title = [[新手]];
    hall_page_yuanbao_item_layout_online = [[在玩 1234 人]];
    hall_page_yuanbao_item_layout_base_chip_text = [[底]]];
    hall_page_yuanbao_item_layout_gold_text = [[金]];
    layout_hall_matchitem_tv_title = [[0:00-23:00]];
    layout_hall_matchitem_tv_desc = [[你妹!]];
    layout_hall_matchitem_tv_detail_label = [[情]];
    layout_hall_matchitem_bt_apply_label = [[竺]];

    gold_info_fragment_g_user_money_text = [[Ya：12413164]];
    gold_info_fragment_g_user_level_text = [[等：小W啄昙]];
    gold_info_fragment_user_money_bt_label = [[I金]];
    gold_info_fragment_day_count_text = [[今日共M行的局]];
    gold_info_fragment_day_win_text = [[倬]];
    gold_info_fragment_day_lost_text = [[局]];
    gold_info_fragment_day_count_gold_text = [[@得金]];
    gold_info_fragment_gold_info_tip_text = [[剀疤崾: 人鹂10分更新一次]];
    layout_pay_guid_title = [[金挪蛔]];
    layout_pay_guid_content = [[金挪蛔]];
    layout_pay_guid_name = [[4,500金]];
    layout_pay_guid_price = [[￥1.0]];
    layout_pay_guid_cancel_tx = [[去低倍]];
    layout_pay_guid_ok_tx = [[I]];
    room_score1_button_layout_one_point_txt = [[1 分]];
    layout_match_delivery_card_dialog_title = [[I取 ￥100手CM]];
    layout_match_delivery_card_dialog_phone_title = [[入您要χ档氖Ca]];
    layout_match_delivery_card_dialog_comit_tx = [[_Jχ]];
    layout_match_delivery_card_dialog_info = [[剀疤崾荆涸M钚枰等待一定的核，需1~2工作日鹊劫~]];
    create_room_layout_dialog_title = [[建房g]];
    create_room_layout_room_name_text = [[房g名Q:]];
    create_room_layout_room_name_edit_box = [[An0~地主老蔡]];
    create_room_layout_room_pwd_text = [[房g密a:]];
    create_room_layout_room_pwd_edit_box = [[最多10底]];
    create_room_layout_room_pwd_tip_text = [[可不O]];
    create_room_layout_combox_title = [[底]型:]];
    create_room_layout_combox_text = [[金]];
    create_room_layout_create_room_btn_text = [[建房g]];
    commit_user_info_dialog_layout_title_text = [[Q成功]];
    commit_user_info_dialog_layout_card_text = [[10元χ悼]];
    commit_user_info_dialog_layout_yuanbao_text = [[需要400元]];
    commit_user_info_dialog_layout_name_text = [[姓名:]];
    commit_user_info_dialog_layout_num_text = [[a:]];
    commit_user_info_dialog_layout_email_text = [[]箱:]];
    commit_user_info_dialog_layout_address_text = [[地址:]];
    commit_user_info_dialog_layout_tips = [[剀疤崾荆邯品⒃1~2工作日l放]];
    commit_user_info_dialog_layout_bt_ok_text = [[_J提交]];
    login_cmcc_layout_yes_btn_text = [[是]];
    login_cmcc_layout_no_btn_text = [[否]];
    wifi_hall_layout_title = [[鹉Ｊ]];
    wifi_hall_layout_back_txt = [[返回]];
    wifi_hall_layout_htc_txt = [[HTC品牌Android2.3以下系y的手C目前翰恢С肿铀WLAN局域W鹊闹C，您可以L建立主C朋友砑尤搿]];
    wifi_hall_layout_apple_txt = [[由於O果公司的接口限制，博雅Y地主Android版本o法支持ciPhone版本M行WLANC，o您淼牟槐憔凑解。]];
    wifi_hall_layout_feedback_txt = [[如果您ξ的[蛴幸庖或建h，可在登入椭中心致或l送]件o我的客服，感x您ξ的支持！]];
    room_call_landlord_buttons_layout_pass_call_txt = [[不 叫]];
    room_call_landlord_buttons_layout_call_landlord_txt = [[叫地主]];
    layout_hall_hall_bt_back_label = [[返回]];
    layout_hall_hall_bt_game_label = [[三人Y地主]];
    layout_hall_hall_bt_four_label = [[四人Y地主]];
    layout_hall_hall_bt_match_label = [[比]];
    layout_hall_hall_bt_private_label = [[私人房]];
    hall_page_match_item_layout_title = [[高手x拔]];
    hall_page_match_item_layout_detail = [[最高睿240,000 金]];
    hall_page_match_item_layout_right_desc = [[09:00 - 11:00]];
    hall_page_match_item_layout_detail_text = [[  ]];
    hall_page_match_item_layout_btn_signup_text = [[  名]];
    layout_match_xin_bt_rule_title = [[事t]];
    layout_match_xin_bt_myrank_title = [[我的鹂]];
    layout_match_xin_bt_todayrank_label = [[前排名]];
    layout_match_xin_bt_personalrecord_label = [[人]];
    wifi_table_caption = [[_新牌局]];
    web_view_layout_return_tx = [[返回]];
    web_view_layout_title_text = [[[私政策]];
    room_setting_layout_text_1 = [[音效]];
    room_setting_layout_text_2 = [[音]];
    room_setting_layout_text_3 = [[亮度]];
    room_setting_layout_text_5 = [[o音模式]];
    room_setting_layout_text_6 = [[Z音x牌]];
    room_setting_layout_text_7 = [[[蛘]];
    room_setting_layout_text_8 = [[屏蔽聊天]];
    task_layout_task_back_bt_text = [[返回]];
    task_layout_sys_task_bt_text = [[系y任]];
    task_layout_daily_task_bt_text = [[每日任]];
    task_layout_completed_task_bt_text = [[已完成任]];
    hall_match_info_dialog_layout_match_rules_btn_text = [[比t]];
    hall_match_info_dialog_layout_awards_btn_text = [[@]];
    hall_match_info_dialog_layout_rules_text = [[比t比t比t比t]];
    hall_match_info_dialog_layout_date_text = [[日期]];
    hall_match_info_dialog_layout_match_event_text = [[龃]];
    hall_match_info_dialog_layout_match_places_text = [[名次]];
    hall_match_info_dialog_layout_reward_text = [[]];
    hall_match_info_dialog_layout_check_text = [[查看]];
    layout_marker_record_title = [[牌器(3天)]];
    layout_marker_record_state = [[Irg：2013.03.18 00:17:41]];
    match_act_dlg_rewardlist_tv_master_score = [[大分:0]];
    match_act_dlg_rewardlist_tv_title = [[MZ]];
    match_act_dlg_rewardlist_tv_nums = [[已竺1人，18:00]];
    match_act_dlg_rewardlist_bt_label = [[免MM]];
    match_act_dlg_rewardlist_tv_cost = [[①o需任何M用]];
    bet_layout_bt_buy_text = [[投]猜猜]];
    bet_layout_bt_info_text = [[tf明]];
    bet_layout_bt_history_text = [[中o]];
    bet_layout_cur_money_text = [[F有金:]];
    bet_layout_tv_bet_limit = [[至少需要15000金挪拍芟略]]];
    bet_layout_odds_text = [[今日r率:]];
    bet_layout_choose_text = [[x裢对]金~:]];
    bet_layout_one_bt_text = [[1500金]];
    bet_layout_two_bt_text = [[4500金]];
    bet_layout_three_bt_text = [[15000金]];
    bet_layout_buy_next_bt_text = [[投]下局]];
    bet_layout_buy_every_bt_text = [[投]每局]];
    bet_layout_tv_odds_type1 = [[火箭(4倍)]];
    bet_layout_tv_odds_type2 = [[wC(7倍)]];
    bet_layout_tv_odds_type3 = [[子(1倍)]];
    bet_layout_tv_odds_type4 = [[B(2.5倍)]];
    bet_layout_tv_odds_value4 = [[4倍]];
    bet_layout_bet_info_textView = [[投]猜猜罚]];
    bet_layout_game_text = [[[]];
    bet_layout_tv_money = [[中金~]];
    bet_layout_tv_history = [[中rg]];
    new_layout_face_edit_text = [[入文字]];
    new_layout_face_send_btn_text = [[l送]];
    new_layout_face_tip_text = [[剀疤崾荆]];
    new_layout_face_face_btn_text = [[表情]];
    new_layout_face_chat_btn_text = [[常用Z]];
    new_layout_face_his_chat_btn_text = [[聊天]];
    new_layout_face_tip_text2 = [[喇叭可以在商城中I]];
    user_info_fragment_head_update_text = [[c粜薷念^像]];
    user_info_fragment_user_nick_editor = [[昵Q]];
    user_info_fragment_addiction_bt_label = [[名JC]];
    user_info_fragment_addiction_yes_label = [[已JC]];
    user_info_fragment_sex_man_text = [[男生]];
    user_info_fragment_sex_women_text = [[女生]];
    user_info_fragment_user_winrate_text = [[俾剩44%]];
    user_info_fragment_user_level_text = [[等：11]];
    user_info_fragment_user_type_text = [[用簦翰┭庞]];
    user_info_fragment_user_id_text = [[ID:193]];
    room_score2_button_layout_two_point_txt = [[2 分]];
    task_item_layout_task_title = [[小心一c]];
    task_item_layout_progress_title = [[M度]];
    task_item_layout_task_reward = [[I取1500金]];
    task_item_layout_reward_bt_text = [[免MI取]];
    room_vip_grab_landlord_buttons_layout_pass_grab_txt = [[不]];
    room_vip_grab_landlord_buttons_layout_grab_lordland_txt = [[地主]];
    setting_title_txt = [[O定]];
    setting_back_txt = [[返回]];
    private_item_layout_name = [[房g名]];
    private_item_layout_basechip = [[底]]];
    private_item_layout_num = [[人]];
    rank_item_layout_rank_text = [[未入榜]];
    rank_item_layout_rank_msg = [[昨日χ:]];
    rank_item_layout_user_name = [[工程F]];
    new_login_layout_caption = [[更新版本]];
    ingot_exchange_dialog_layout_title_text = [[Q品]];
    ingot_exchange_dialog_layout_card_text = [[100元χ悼]];
    ingot_exchange_dialog_layout_yuanbao_text = [[需要400元]];
    ingot_exchange_dialog_layout_bt_ok_text = [[_J丢]];
    bet_history_item_game_text = [[[]];
    bet_history_item_tv_money = [[中金~]];
    bet_history_item_tv_history = [[中rg]];
    match_fast_apply_tv_nums = [[M人即_，全天]];
    match_fast_apply_tv_cost = [[①o需任何M用]];
    match_fast_apply_tv_reward_first = [[冠:xxxx+xxxx]];
    match_fast_apply_bt_reward_detail_label = [[钤情>]];
    match_fast_apply_bt_apply_volume_label = [[①券竺]];
    match_fast_apply_bt_apply_money_label = [[金竺]];
    match_fast_apply_tv_volume = [[00]];
    dialog_layout_dialog_ok_bt_text = [[_定]];
    dialog_layout_dialog_cancle_bt_text = [[取消]];
    --dialog_layout_dialog_title_text = [[       ]]
    room_user_info_layout_gold_text = [[金:]];
    room_user_info_layout_record_text = [[鹂:]];
    room_user_info_layout_record = [[11/14]];
    room_user_info_layout_win_rate_text = [[俾:]];
    room_userinfo_view_layout_ingotLable = [[元:]];
    layout_match_notify_dialog_title = [[I取 Iphone5]];
    layout_match_notify_dialog_name = [[收人姓名：]];
    layout_match_notify_dialog_phone = [[手Ca：]];
    layout_match_notify_dialog_email = [[子]件：]];
    layout_match_notify_dialog_address = [[收地址：]];
    layout_match_notify_dialog_notice = [[罴⒓某觯如有疑系客服]];
    wait_timing_match_layout_tv_title = [[超快]];
    wait_timing_match_layout_tv_timing_title = [[超快竺成功]];
    wait_timing_match_layout_tv_countdown = [[_倒r]];
    wait_timing_match_layout_tv_times = [[03:52]];
    wait_timing_match_layout_tv_tips = [[Tips：比r是不允S聊天和l表情的哦]];
    wait_timing_match_layout_quit_bt_txet = [[退]];
    wait_timing_match_layout_back_bt_text = [[返回大d]];
    wait_timing_match_layout_reward_bt_text = [[比]];
    layout_match_fastrace_bt_rule_title = [[事t]];
    layout_match_fastrace_bt_record_title = [[@]];
    buy_trump_dialog_layout_title = [[l息需要消耗喇叭，是否I？]];
    buy_trump_dialog_layout_text_1 = [[用於l送喇叭息]];
    buy_trump_dialog_layout_price = [[$3.99]];
    buy_trump_dialog_layout_cancle_btn_text = [[去商城]];
    buy_trump_dialog_layout_buy_btn_text = [[I]];
    room_grab_landlord_buttons_layout_pass_grab_txt = [[不]];
    room_grab_landlord_buttons_layout_grab_lordland_txt = [[地主]];
    layout_hall_gameitem_hall_gameitem_name = [[新手]];
    layout_hall_gameitem_hall_gameitem_online = [[在玩人:]];
    layout_hall_gameitem_hall_gameitem_basechip_label = [[底]:]];
    room_pass_score_button_layout_dont_call_txt = [[不 叫]];
    wifi_join_table_layout_wait_parter = [[正在等待牌友加入...]];
    wifi_table_layout_caption = [[_新牌局]];
    room_virtual_tips_layout_caption = [[c洌M入自优渥肋[]];
    layout_match_card_notify_dialog_title = [[正在核￥100手CM]];
    game_over_layout_total = [[共 3 倍]];
    game_over_layout_nick_tag = [[昵Q]];
    game_over_layout_result_tag = [[儇]];
    game_over_layout_exp_tag = [[]];
    game_over_layout_money_tag = [[我的金牛]];
    game_over_layout_win_nums = [[去高底]鲒A牌可以@得元]];
    game_over_layout_play_again_txt = [[再硪痪]];
    game_over_ant = [[底注：]];
    game_over_mul = [[倍担]];
    game_over_exp = [[：]];
    game_over_total_gold = [[我的金牛]];
    game_over_gold = [[金牛]];
    game_over_share = [[分 享]];
    game_over_play_again = [[再硪痪]];
    game_over_lordland_sprint = [[恭喜地主打出了春天，在是太害了！]];
    game_over_farmer_sprint = [[恭喜r民打出了春天，在是太害了！]];
    game_over_no_toomuchmoney_tip_str = [[您金胚^少，可能被踢出房g，及ra充。]];
    layout_private_list_item_name = [[房g名]];
    layout_private_list_item_basechip = [[底]]];
    layout_private_list_item_num = [[人]];
    match_content_rank_tv_rank = [[排名]];
    match_content_rank_tv_nick = [[玩家昵Q]];
    match_content_rank_tv_levelname = [[[蚍Q]];
    match_content_rank_tv_level = [[等]];
    match_content_rank_tv_score = [[e分值]];

    buy_money_dialog_layout_dialog_title_text = [[金挪蛔]];
    buy_money_dialog_layout_dialog_content_textview = [[您的金挪蛔悖是否χ?]];
    prop_item_layout_prop_title_1 = [[]];
    prop_item_layout_prop_mount_1 = [[剩余盗]];
    prop_item_layout_prop_title_2 = [[3000①卷]];
    prop_item_layout_prop_mount_2 = [[剩余137]];
    prop_item_layout_prop_title_3 = [[300①卷]];
    prop_item_layout_prop_mount_3 = [[剩余124]];
    prop_info_fragment_prop_go_market_text = [[去道具商城]];
    match_finish_dialog_layout_bt_back_label = [[返回大d]];
    match_finish_dialog_layout_bt_apply_label = [[竺下一]];
    match_finish_dialog_layout_tv_title = [[     ]];
    match_finish_dialog_layout_bt_share_label = [[分享]];
    pay_card_dialog_title = [[正在核 ￥100手CM]];
    pay_card_dialog_num_info = [[你的钜呀_入手C18682105864, ]意查收！]];
    pay_card_dialog_help_text = [[如有疑按以下方式系客服]];
    quick_pay_layout_title_text = [[快捷χ]];
    quick_pay_layout_content_text = [[F在I4500金牛只需1KX哦！]];
    quick_pay_layout_name = [[4,500金]];
    quick_pay_layout_price = [[￥:1.0]];
    quick_pay_layout_cancel_text = [[取 消]];
    quick_pay_layout_buy_text = [[ I]];
    new_user_info_fragment_head_update_text = [[c粜薷念^像]];
    new_user_info_fragment_user_nick_editor = [[昵Q]];
    new_user_info_fragment_addiction_bt_label = [[名JC]];
    new_user_info_fragment_addiction_yes_label = [[已JC]];
    new_user_info_fragment_sex_man_text = [[男生]];
    new_user_info_fragment_sex_women_text = [[女生]];
    new_user_info_fragment_user_money_bt_label = [[I金]];
    new_user_info_fragment_user_winrate_text = [[俾剩44%]];
    new_user_info_fragment_user_level_text = [[等：11]];
    new_user_info_fragment_user_type_text = [[用簦翰┭庞]];
    new_user_info_fragment_user_id_text = [[ID:193]];
    layout_bottom_navi_bottom_navi_feedback_txt = [[回]];
    layout_bottom_navi_bottom_navi_rank_txt = [[排行榜]];
    match_reward_layout_MatchRewardTitle = [[比]];
    match_rest_waiting_rank_bt_txet = [[前排行]];
    match_rest_waiting_exit_bt_text = [[退出比]];
    match_rank_layout_tv_match_rank_rank = [[名次]];
    match_rank_layout_tv_match_rank_name = [[昵Q]];
    match_rank_layout_tv_match_rank_score = [[比e分]];
    match_rank_layout_tv_my_name = [[臧致平]];
    match_rank_toolbar_layout_tv_match_rank_rank = [[名次]];
    match_rank_toolbar_layout_tv_match_rank_name = [[昵Q]];
    match_rank_toolbar_layout_tv_match_rank_score = [[比e分]];
    match_rank_toolbar_layout_tv_my_name = [[臧致平]];
    match_over_bt_back_label = [[返回大d]];
    match_over_bt_apply_label = [[竺下一]];
    match_over_bt_share_label = [[分享]];
    layout_pay_seldialog_gamemoney = [[I: 2,800,000金]];
    layout_pay_seldialog_price = [[r格: 350元]];
    layout_pay_seldialog_title = [[_Jχ捣绞:]];
    layout_pay_seldialog_notice = [[提示：χ的壳H支持部分地^和\I商的用簦解。]];
    hall_page_item_layout_freshman_text = [[新手]];
    hall_page_item_layout_online_text = [[在玩 1234 人]];
    hall_page_item_layout_base_chip_text = [[底]]];
    hall_page_item_layout_gold_text = [[底]];
    billboard_item_layout_item_title = [[息通知祟}]];
    billboard_item_layout_item_content = [[如果有非常重要的息公告，t在用舻侨脶幔出息公告框，提示用舨榭聪的公告热荩在每日必做的面]];
    room_vip_userinfo_view_layout_money_text = [[金牛]];
    room_vip_userinfo_view_layout_record_text = [[鹂：]];
    room_vip_userinfo_view_layout_record = [[11/14]];
    room_vip_userinfo_view_layout_win_rate_text = [[俾剩]];
    room_vip_userinfo_view_layout_ingotLable = [[元: ]];
    ddz3_toolbar_fb_layout_bt_exit_text = [[退出]];
    ddz3_toolbar_fb_layout_bt_change_text = [[Q桌]];
    ddz3_toolbar_fb_layout_bt_sort_text = [[排序]];
    ddz3_toolbar_fb_layout_toolbar_bt_set = [[O定]];
    -- room_toolbar_single_bt_exit_text
    -- room_toolbar_single_bt_change_text
    -- room_toolbar_single_
    -- room_toolbar_single_
    room_toolbar_fb_bt_exit_text = [[退出]];
    room_toolbar_fb_bt_change_text = [[Q桌]];
    room_toolbar_fb_bt_sort_text = [[排序]];
    room_toolbar_fb_toolbar_bt_set = [[O定]];


    match_content_rule_tv_title = [[事t]];
    market_layout_gold_title = [[金:]];
    market_layout_buyGoldsTx = [[金]];
    market_layout_returnTx = [[返回]];
    market_layout_daojuTx = [[道具]];
    market_layout_vipTx = [[IVIP]];
    market_layout_recordTx = [[特殊道具]];
    market_golds_view_layout_buytx = [[I]];
    market_vip_view_layout_buytx = [[I]];
    match_content_personal_record_tv_title1 = [[rg]];
    match_content_personal_record_tv_title2 = [[e分值]];
    match_content_personal_record_tv_title3 = [[rg]];
    match_content_personal_record_tv_title4 = [[e分值]];
    match_content_activity_record_tv_title = [[@]];
    match_content_activity_record_tv_date = [[日期]];
    match_content_activity_record_tv_rank = [[名次]];
    match_content_activity_record_tv_reward = [[]];
    match_content_activity_record_tv_status = [[B]];
    match_combat_item_layout_tv_time = [[rg]];
    match_combat_item_layout_tv_type = [[王霸]];
    match_combat_item_layout_tv_rank = [[排行]];
    match_combat_item_layout_bt_receive_tx = [[I取]];
    match_content_record_tv_title = [[@]];
    match_content_record_tv_date = [[日期]];
    match_content_record_tv_rank = [[名次]];
    match_content_record_tv_gameid = [[龃]];
    match_content_record_tv_reward = [[]];
    match_content_record_tv_status = [[]];


    login_union_layout_change_text = [[切Q~]];
    login_txt = [[公告]];
    login_version = [[version: ]];
    layout_vip_tiem_view_title = [[Y地主VIP（30天）]];
    layout_vip_tiem_view_tips = [[I即可@得VIP特嗌矸菀月]];
    layout_vip_tiem_view_buytx = [[I]];
    layout_vip_tiem_view_price = [[r格：￥30.0]];
    layout_select_login_youkeText = [[[客登入]];
    layout_match_ready_delivery_dialog_title = [[I取 Iphone5]];
    layout_match_ready_delivery_dialog_name = [[收人姓名：]];
    layout_match_ready_delivery_dialog_phone = [[手Ca：]];
    layout_match_ready_delivery_dialog_email = [[子]件：]];
    layout_match_ready_delivery_dialog_address = [[收地址：]];
    layout_match_ready_delivery_dialog_modify_tx = [[修改地址]];
    layout_match_ready_delivery_dialog_notice = [[罴⒓某觯您仍可修改寄送息，如有疑系客服]];
    layout_match_address_dialog_title = [[I取 Iphone5]];
    layout_match_address_dialog_name = [[收人姓名：]];
    layout_match_address_dialog_phone = [[手Ca：]];
    layout_match_address_dialog_email = [[子]件：]];
    layout_match_address_dialog_address = [[收地址：]];
    layout_match_address_dialog_reward_tx = [[_Jl地址]];
    layout_match_activity_bt_rule_title = [[事t]];
    layout_match_activity_bt_record_title = [[@]];
    game_over_layout_total = [[共 3 倍]];
    game_over_layout_nick_tag = [[昵Q]];
    game_over_layout_result_tag = [[儇]];
    game_over_layout_exp_tag = [[]];
    game_over_layout_money_tag = [[我的金牛]];
    game_over_layout_win_nums = [[去高底]鲒A牌可以@得元]];
    game_over_layout_close_txt = [[返回牌桌]];
    game_over_layout_play_again_txt = [[再硪痪]];

    ingot_item_layout_desc = [[5元χ悼]];
    ingot_item_layout_num = [[剩余0]];
    ingot_item_layout_preis = [[需要200元]];
    ingot_item_layout_bt_exchange_text = [[丢]];
    ingot_layout_backBtnTx = [[返回]];
    ingot_layout_ingotTx = [[元：]];
    ingot_layout_exchangeBtnTx = [[元Q]];
    ingot_layout_recordBtnTx = [[元]];
    ingot_layout_taskBtnTx = [[元任]];
    ingot_layout_goods_name = [[商品]];
    ingot_layout_goods_date = [[日期]];
    ingot_layout_goods_no = [[翁]];
    ingot_layout_goods_state = [[B]];
    ingot_layout_ingot_text = [[元]];
    ingot_layout_ingot_desc = [[集R元即可在元商城Q物]];
    ingot_layout_earnIngotBtnTx = [[取元]];

    layout_login_update_pop_updateTipText = [[提示更新文本]];
    layout_login_update_pop_updateBtnText = [[立即更新]];
    layout_interflow_title_text = [[交流^]];
    layout_interflow_edit_text = [[l送息需要消耗喇叭]];
    layout_interflow_bottom_text = [[使用喇叭道具l送息，全鐾婕叶伎梢越邮盏脚]];
    layout_interflow_send_btn_text = [[l送]];
    layout_interflow_laba_count_text = [[99+]];
    layout_hall_private_hall_private_search_et = [[搜ID]];
    layout_hall_private_hall_private_title_name = [[房g名]];
    layout_hall_private_hall_private_title_basechip = [[底]]];
    layout_hall_private_hall_private_title_num = [[人]];
    layout_hall_private_hall_private_title_pwd = [[密a]];
    layout_hall_private_tv_totop = [[回到部]];
    layout_hall_private_bt_game2_label = [[二人血]];
    layout_hall_private_bt_game3_label = [[典三人]];

    room_card_buttons_layout_pass_txt = [[不出]];
    room_card_buttons_layout_reselect_txt = [[重x]];
    room_card_buttons_layout_tip_txt = [[提示]];
    room_card_buttons_layout_out_card_txt = [[出牌]];
    layout_hall_enterpwd_hall_enterpwd_title = [[入密a]];
    layout_hall_enterpwd_hall_enterpwd_et = [[私人房密a]];
    layout_hall_enterpwd_hall_enterpwd_bt_ok_label = [[_定]];
    layout_hall_enterpwd_hall_enterpwd_bt_cancel_label = [[取消]];
    layout_face_chatTextEdit = [[本r只允Sl送表情和常用Z]];
    layout_face_tisText1 = [[剀疤崾荆涸表情需要I]];
    layout_create_room_tv_title = [[建私人房]];
    layout_create_room_tv_name_title = [[房g名]];
    layout_create_room_tv_name = [[入房g名]];
    layout_create_room_tv_pwd_title = [[密   a]];
    layout_create_room_tv_pwd = [[密a(可榭)]];
    layout_create_room_tv_basechip_title = [[底   ]]];
    layout_create_room_bt_ok_label = [[建房g]];
    layout_create_room_bt_cancel_label = [[取消]];

    tip_dialog_layout_title = [[剀疤崾]];
    tip_dialog_layout_msg = [[再打N局就可以升到M，可以@得XX睿]];
    tip_dialog_layout_bt_cancel_label = [[取消]];
    tip_dialog_layout_bt_ok_label = [[^m局]];


    create_room_layout_step1_name_label = [[房g名Q：]];
    create_room_layout_step1_pwd_label = [[密a：]];
    create_room_layout_step1_roomtype_label = [[x裢娣ǎ]];
    create_room_layout_step1_bt_2_label = [[p人血]];
    create_room_layout_step1_bt_3_label = [[典三人]];
    create_room_layout_step1_bt_label = [[下一步]];
    create_room_layout_step1_pwd_tip = [[可不O]];

    create_room_layout_step2_tv = [[x竦鬃（金牛]];
    create_room_layout_step2_tv_tip = [[p人血鹜娣龋每局的A是固定值]];
    create_room_layout_step2_bt_label2 = [[建房g]];


    activity_layout_backBtnTx = [[返回]];
    activity_layout_title_txt = [[活又行]];
    -- layout_activity_activityCenterTx = [[活又行]];
    -- layout_activity_commendBtnTx = [[用推]]]
    -- layout_activity_activityTipStr = [[新活蛹㈤_,⒕凑期待]]

    vip_info_fragment_vip_msg_text = [[您有%1$sc成L值即可升 V%2$sT（%3$s天後到期）]];
    vip_info_fragment_vip_level_text = [[LV.%1$s (%2$s/%3$s)]];
    vip_info_fragment_vip_grow_text = [[VIP成L中]];
    vip_info_fragment_vip_privilege_des_text = [[@得的特 :]];
    vip_info_fragment_become_vip_bt_text = [[成VIP]];

    
    daily_tasks_layout_billboardTabEmpty = [[o公告热]];
   

    ddz4_desc_dialog_layout_title = [[主要牌型]];


    match_room_rank_item_layout_tv_my_name = [[臧致平]];


    user_info_layout_user_info_back_text = [[返回]];
    user_info_layout_user_info_bt_txt = [[人Y]];
    user_info_layout_user_money_info_bt_text = [[金刨Y]];
    user_info_layout_my_info_bt_text = [[我的Y]];
    user_info_layout_my_vip_info_bt_text = [[我的特]];
    user_info_layout_my_props_bt_text = [[我的道具]];
    user_info_layout_my_buy_history_bt_text = [[I]];

    user_info_with_ingot_fragment_head_update_text = [[c粜薷念^像]];
    user_info_with_ingot_fragment_user_nick_editor = [[昵Q]];
    user_info_with_ingot_fragment_addiction_bt_label = [[名JC]];
    user_info_with_ingot_fragment_addiction_yes_label = [[已JC]];
    user_info_with_ingot_fragment_sex_man_text = [[男生]];
    user_info_with_ingot_fragment_sex_women_text = [[女生]];
    user_info_with_ingot_fragment_user_winrate_text = [[俾剩44%]];
    user_info_with_ingot_fragment_user_level_text = [[等：11]];
    user_info_with_ingot_fragment_user_type_text = [[用簦翰┭庞]];
    user_info_with_ingot_fragment_user_id_text = [[ID:193]];


    switch_layout_switch_on_text = [[_]];
    switch_layout_switch_off_text = [[P]];

    report_dialog_layout_bt_cancel_label = [[取消]];
    report_dialog_layout_bt_ok_label = [[e]];

    room_toolbar_ddzbug_bt_change_text = [[Q桌]];

    room_userinfo_view_layout_bt_report_label = [[e]];

    cdkey_layout_change_verificate_btn_txt = [[更QCa]];
    paid_guide_dialog_layout_title = [[M鼋挪蛔]];
    paid_guide_dialog_layout_tip = [[F在I送~外]];
    paid_guide_dialog_layout_include_gift_title = [[χ蹈剿停]];
    paid_guide_dialog_layout_include_vip_gift_title = [[χ蹈剿停]];
    paid_guide_dialog_layout_tolowTip = [[金挪蛔悖可以x袢サ捅]];
    paid_guide_dialog_layout_tolowBtnTx = [[去低倍]];

    unpaid_guide_dialog_layout_title = [[M鼋挪蛔]];
    unpaid_guide_dialog_layout_tip = [[首次χ邓痛蠖Y]];
    unpaid_guide_dialog_layout_tolowTip = [[金挪蛔悖可以x袢サ捅]];
    unpaid_guide_dialog_layout_tolowBtnTx = [[去低倍]];
    unpaid_guide_dialog_layout_gift_desc = [[  送]];

    pay_select_dialog_layout_title_tx = [[xχ捣绞]];
    pay_select_dialog_layout_buy_title_tx = [[I:]];
    pay_select_dialog_layout_price_title_tx = [[r格:]];
    pay_select_dialog_layout_more_btn_tx = [[更多]];
    pay_select_dialog_layout_enter_btn_text = [[_定]];

    pay_guid_dialog_layout_title = [[金挪蛔]];
    pay_guid_dialog_layout_content = [[金挪蛔]];
    pay_guid_dialog_layout_name = [[4,500金]];
    pay_guid_dialog_layout_price = [[￥1.0]];
    pay_guid_dialog_layout_cancel_tx = [[去低倍]];
    pay_guid_dialog_layout_ok_tx = [[I]];

    quick_pay_dialog_layout_title_text = [[快捷χ]];
    quick_pay_dialog_layout_new_user_title_text = [[新注杂7天χ邓痛蠖Y]];
    quick_pay_dialog_layout_product_name = [[9,000金]];
    quick_pay_dialog_layout_product_desc = [[1￥=4,500金]];
    quick_pay_dialog_layout_price_txt = [[￥2.00]];
    quick_pay_dialog_layout_product_name = [[9,000金]];
    quick_pay_dialog_layout_product_desc = [[1￥=4,500金]];
    quick_pay_dialog_layout_price_txt = [[￥2.00]];
    quick_pay_dialog_layout_product_name = [[9,000金]];
    quick_pay_dialog_layout_product_desc = [[1￥=4,500金]];
    quick_pay_dialog_layout_price_txt = [[￥2.00]];
    quick_pay_dialog_layout_bottom_tips = [[7天χ荡蠖Y，到大d[I]^I]];
    private_rule_dialog_layout_title = [[p人血鹜娣ㄒt]];


    user_exchange_info_dialog_layout_title = [[已寄出 3星手C]];
    user_exchange_info_dialog_layout_user_name = [[收人姓名:]];
    user_exchange_info_dialog_layout_phone_num = [[手Ca:]];
    user_exchange_info_dialog_layout_email_num = [[子]箱:]];
    user_exchange_info_dialog_layout_email_value = [[archermyc@gmail.com]];
    user_exchange_info_dialog_layout_address_text = [[收地址:]];
    user_exchange_info_dialog_layout_address_value = [[火星|北角23c方向]];
    user_exchange_info_dialog_layout_tips = [[钜鸭某,]意查收，如有疑系客服]];


    bug_newbies_course_layout_titleText = [[]子新手教程]];
    bug_newbies_course_layout_noRemindText = [[不再提醒]];

    layout_match_real_edit_dialog_tv_title = [[I取 0M]];
    layout_match_real_edit_dialog_bt_label = [[_J提交]];
    layout_match_real_edit_dialog_tv_name = [[姓名：]];
    layout_match_real_edit_dialog_tv_phone = [[a：]];
    layout_match_real_edit_dialog_tv_email = [[]箱：]];
    layout_match_real_edit_dialog_tv_address = [[地址：]];
    layout_match_real_edit_dialog_tv_tip = [[剀疤崾荆涸M⒃7工作日劝l放]];

    new_game_over_layout_myMoneyTx = [[金牛]];
    new_game_over_layout_expValueTx = [[：+]];
    new_game_over_layout_myTotalMoneyTx = [[金牛]];
    new_game_over_layout_broadcastTxt = [[你好害，快W鹋c真人一起Q鸢桑]];
    new_game_over_layout_closeTx = [[返回牌桌]];
    new_game_over_layout_shareTx = [[分享]];
    new_game_over_layout_playAgainTxcloseTx = [[再硪痪]];
    new_game_over_layout_totalMultipleTx = [[共]];
    new_game_over_layout_totalMultipleTx2 = [[倍]];
    new_game_over_layout_detailMulTx = [[查看倍]];
    --------------------------------------- vip------------------------------
    svip_guide_dialog_layout_title = [[恭喜@得Y地主超VIPTY格]];
    svip_guide_dialog_layout_privilege_head_text = [[R上加入超VIP俱凡浚即享以下福利：]];
    svip_guide_dialog_layout_gift_text1 = [[完善Y料後即可@得]];
    svip_guide_dialog_layout_gift_text2 = [[超VIP品Y地主公仔壹]];
    svip_guide_dialog_layout_join_btn_text = [[R上加入K完善Y料]];
    vip_dredge_dialog_layout_title = [[_通VIP]];
    vip_dredge_dialog_layout_detail_title = [[~外送至尊Y包！]];
    vip_dredge_dialog_layout_item1_title = [[壹月]];
    vip_dredge_dialog_layout_item2_title = [[三月]];
    vip_dredge_dialog_layout_item3_title = [[年M(推])]];
    vip_dredge_dialog_layout_buyBtnTx = [[成VIP]];
    vip_introduce_dialog_layout_title = [[VIP特]];
    vip_introduce_dialog_layout_buyBtnTx = [[成VIP]];
    vip_expire_dialog_layout_title_text = [[剀疤崾]];
    vip_expire_dialog_layout_tip = [[您的VIP已^期，失去所有特啵VIP流失中，了避免您的p失，及rmM！]];
    vip_expire_dialog_layout_noRemindText = [[不再提醒]];
    vip_expire_dialog_layout_renewalBtnTx = [[m M]];
    svip_privilege_item_layout_privilege_name = [[生日Y物]];
    svip_privilege_item_layout_privilege_detail_desc = [[生日r刻，小地主砩衩刈８]];
    vip_remind_dialog_layout_tip = [[您的VIP不足%d天,即⒉荒茴I取5000金K失去所有VIP特啵]];
    vip_remind_dialog_layout_renewalBtnTx = [[m M]];
    svip_info_form_dialog_layout_title = [[超VIPT息]];
    svip_info_form_dialog_layout_submit_text = [[提交成超VIP]];
    svip_info_form_dialog_layout_tips = [[（了您能利收到限量版公仔，毡赝瓿*的热菖叮]];
    vip_convert_dialog_layout_title_text = [[VIP升活]];
    vip_convert_dialog_layout_tip1 = [[活邮Ｓrg：%s]];
    vip_convert_dialog_layout_tip2 = [[使用365天普通VIP，可免M升年MVIPK可@得更多特]];
    vip_convert_dialog_layout_tip3 = [[您的普通VIP天：%d天]];
    vip_convert_dialog_layout_convertBtnTx = [[免M升]];
    svip_form_content_layout_phone_label = [[您的手提]];
    svip_form_content_layout_sns_label = [[社交~]];

    new_login_item_layout_online_label = [[在玩人]];

    newer_layout_face_face_txt = [[表情]];
    newer_layout_face_frequent_txt = [[常用Z]];
    newer_layout_face_chat_txt = [[聊天]];
    newer_layout_face_tip_txt = [[剀疤崾]];
    newer_layout_face_send_txt = [[l送]];
    newer_layout_face_chat_broadcast_tip = [[使用小喇叭可以l送全服V播]];

    activity_promote_dialog_layout_noContentTips = [[H鄣耐婕遥今日o狳c活油扑]，小地主祝您[蛴淇欤]];

    room_myself_info_layout_gold_text = [[金牛]];
    room_myself_info_layout_record_text = [[鹂：]];
    room_myself_info_layout_win_rate_text = [[俾剩]];
    friend_layout_noMessageTx = [[o好友消息]];




	----------------------- new_login---------------------
    loginCallBackStr = "登入哒{";
    loginSuccessStr = "登入成功";
    loginStartDebugDataStr = "_始{登入";
    openKictOutUserStr = "打_踢人功能";
    isVipUserStr = "玩家是VIP";
    loginFailStr = "登入失";
    loginUpdateGCStr = "Win32不更新gz";

	--------------------------- task--------------------
    doingTaskStr = "去做任";
    getRewardStr = "I取";
	finishTaskStr = "已完成";
    finishRewardStr = "已I";
    rewardGetingStr = "请求中";
	----------------------------
    onetimechipStr = "尉州A";
	onetimeanteStr = "底注";

    privateCardsNumStr = "9";
    privateCardsNumStr1 = "";
    privateCardsNumStr2 = "0";
    privatetips1 = "每一次地主，r民被牌+1";
    privatetips2 = "Ψ浇挪蛔尉州A定~";
    privatetips3 = "尉州A定~:%s";
    privatetips4 = "γ%s";
    privatetips5 = "%s";
    privatetips6 = "牌即可@";
    privatetips7 = "牌,Ψ街恍枰再";
    privatetips8 = "牌,只需要再";
    privatetips9 = "玩法f明";

    privateRuleStr1 = "玩法t:";
    privateRuleStr2 = "牌烊コ3和4;";
    privateRuleStr3 = "p方可互4次地主,每一次地主,r民被牌+1;";
    privateRuleStr4 = "儇t:";
    privateRuleStr5 = "地主倮:要求打完所有牌;";
    privateRuleStr6 = "r民倮:手牌≤牌盗;";
    privateRuleStr7 = "牌型f明:";
    privateRuleStr8 = "c三人典玩法相同;";

    shortCutPayStr1 = "I取破aa助%d金牛可χ但@取更多金牛";
    shortCutPayStr2 = "今天破aa助已I完，可以χ但@取更多金牛";
    shortCutPayStr3 = "@取商品息失";


    singleName1 = "尾";
    singleName2 = "叫F";
    singleName3 = "貂s";
	singleName4 = "如花";


    roomGameOverBaseChips = "底注：";
    roomGameOverCallScore = "叫地主：";
    roomGameOverBombCount = "炸：";
    roomGameOverSpringCount = "春天：";
    roomGameOverLastCard = "最後手牌：";
    roomGameOverDownCard = "底牌：";
    roomGameOverTask = "特殊任眨";
    roomGameOverPrivateBasechips = "A定~：";
    roomGameOverVisibleCards = "明牌：";
    roomGameOverSingleLoseStr = [[再接再，您可以Wc真人穑]];

    trackDialogTips1 = "君子蟪穑十年不晚，您追的玩家已下。";
    trackDialogTips2 = "^m[";
    trackDialogTips3 = "君子蟪穑十年不晚，您追的玩家已在牌局中。";
    trackDialogTips4 = "金挪蛔悖χ到爬^m追。";
    trackDialogTips5 = "金挪蛔悖不能追玩家到玩家";
    trackDialogTips6 = "_定";

    roomMatchUserInfoMasterScore = "大分:";
	roomMatchUserInfoRank = "排名:";
    roomMatchUserInfoScore = "e分:";
    roomMatchUserInfoWhat = "大分是什麽？";

    userinfoRecordStr = [[%d/%d]];

    settingPrivacyPolicy = "http://www.boyaa.com/mobile/PrivacyPolicy2.html";
    settingTermsofService = "http://www.boyaa.com/mobile/termsofservice2.html";
	settingGoldDeclare = "file:///android_asset/golddeclare.html";

	------------------ 癞子新手教程-----------------
    bugTitle1 = [[1.]子x牌f明：]];
    bugDesc1 = [[叫、地主后，XSC的x褚牌(除大、小王)作榘]子。]];

    bugTitle2 = [[2.]子牌型f明：]];
    bugDesc2_1 = [[①]子是通用的f能牌(不能代替大小王)和其他牌M成任意牌型M合]];
    bugDesc2_2 = [[②]子为出只能作槠浔旧]];

    bugTitle3 = [[3.比  牌    t：]];
    bugDesc3_1 = [[①按三人比牌t]];
    bugDesc3_2 = [[②炸比牌t:]];

    bugCourseTips1 = [[(含1~3]子)]];
    bugCourseTips2 = [[(不含]子)]];
    bugCourseTips3 = [[纯]子炸]];
	bugCourseTips4 = [[火箭]];

    roomGameOverStr1 = "去高倍";
    roomGameOverStr2 = "去高底注鲒A牌可以@得元";
    roomGameOverSingleStr = "WQ";

	-------------------------------------------------

    ------------------ 好友系y-----------------------

    add_friend_layout_researchTx = [[搜]];
    friendRequestAddStr = "求添加好友";
    friendRequestInfoStr = "求好友Y";
    friendRequestGetMessageStr = "@取好友Y";
    friendRequestSearchStr = "搜ず糜奄Y";
    friendRequestSendFreeCoinStr = "求送免M金";
    friendRequestGetFreeCoinStr = "求@取免M金";
    friendRequestAgreeAddStr = "求同意添加好友";
    friendRequestDelMsgStr = "求h除好友息";

    friendAddFriendError4 = "不能添加自己楹糜训呐";
    friendAddFriendError5 = "您已成功添加^好友";

    friendMessageError1 = "Ce`";
    friendMessageError2 = "靛e`！";
    friendMessageError3 = "@取息失。";
    friendMessageError4 = "o息！";

    friendRankError4 = "您r]有好友哦";
    friendRankError5 = "不好意思，ro法刷新好友";

    friendRequestMessageTx = "好友申";
    friendGiftMessageTx = "神秘Y物";
    friendHadAgreedAddBtnStr = "已通^";
    friendRequestAgreeAddBtnStr = "通^申";
    friendAgreeAddError3 = "同意添加好友失∫";

    friendHadGotFreeCoinBtnStr = "已I取";
    friendRequestGetFreeCoinBtnStr = "免MI取";

    friendDelMsgError3 = "h除好友失∫";

    friendGetFreeCoinError3 = "H鄣耐婕,I取神秘Y物r取消";

    friendCoinStr = "金:";
    friendlastLoginTx = "上次在rg";
    friendSendFreeCoinStr = "免M送金";
    friendHadSendFreeCoinStr = "已送";
    friendGetFreeCoinSuccess = "恭喜@取%d免M金";

    friendShowNilFriendTx2Str = "您]有添加好友！";
    friendShowNilFriendTx3Str = "立即邀好友加入>>";
    friendShowMessageStr = "o好友Y";

    friendSearchIDPrompt = "(ID可在人Y查看的)";
    friendSearchIDTextPrompt = "搜ID";
    friendSearchInputNilPrompt = "入的ID不正_,重新入吧!";
    friendSearchInputNotFigurePrompt = "ID都是底值呐,重新入吧!";
    friendSearchIsNilPrompt = "IDY不正_耶,未能查到此Y哦";

    friendSearchError4 = "此用舨淮嬖诎";

    -- 金币整合(more_coin)相关[addBy JeffYang 2014/01/16]
    bankruptGetCoinTipText = "江湖救急,小地主o支援您一P救助金!";
    bankruptOverTimesTipText = "已Y助您多次了哦,已超出小地主的荷耶!";
    bankruptCoinTipText = "在您破a的r候小地主才解囊相助的哦!";
    successGetBankruptCoinText = "您已成功@得小地主oY助的%d金!";
    getBankruptCoinStrText = "I取a助";
    HaveGotBankruptCoinStrText = "前去I";


    getLoginRewardTipText = "H鄣耐婕,您可以前去I取登!";
    vipgetLoginRewardTipText = "尊F的VIP玩家,您可以前去I取登!";
    haveGotLoginRewardText = "已成功I取登,快去c人切磋一下吧!";
	haveBuqianTipText = "你有漏的天的兀快去a吧";
	goToBuqianTipText = "前去a";

    goTogetRewardTipText = "前去I取";
    haveGotRewardStrText = "已I取";
    haveGotRewardToRoomStr = "前去[";
	goToSeeMaskSystemStr = "前去看看";

    haveMaskRewardTipsStr = "您已有任胀瓿,快去I取神秘Y包畎!";
    haveGotMaskRewardTipsStr = "您已I取了任摘,下次再眍I取吧!";
    NewNoMaskTipsStr = "H鄣耐婕,o可做任,敬期待後m精彩!";
    noFinishedMaskStr = "您今天r]有已完成的任张,前去看看吧!";

    NewNoMaskBtnText = "o任";

    more_coin_layout_top_title = [[免MI取金]];
    bankruptMarkText = [[破aa助]];
    loginMarkText = [[登有Y]];
    dailyMarkText = [[每日任]];
    roomChestMardText = [[每日任]];

    call_phone_layout_callphone_tip = "艽螂";
    daily_task_callphone_tip = "您即艽螂";
    daily_task_open_url_tip = "立即更新享受新版晨祗w\n（建h在wifih境e下d）";
    banktrupt_tips_dialog_text = [[您可以在<免M金>里I取破a救金！]];


    private_toolbar_layout_bt_set_text = [[O置]];
    room_toolbar_ddz2_layout_bt_set_text = [[O置]];

    broadcast_layout_tip_text = [[l送全服V播]];
    broadcast_layout_sure_text = [[_Jl送]];


    vipConvertStr = "升活rgY束，敬期待下次活娱_放。";
    vipCendonvertDialogStr = "重新登入.";
	
    wx_app_id = "wx1580357ea4e5d9f1";

    roomDoubleTips1 = "地主金盼催_到%d，o法加倍";
    roomDoubleTips2 = "您的κ纸盼催_到%d，o法加倍";
    roomDoubleTips3 = "您的金盼催_到%d，o法加倍";
	
	-- add by lihuaping, start, 2013-12-09
    -- interactive expression
	builtinInterExpGoldCoin = "金币";
	builtinInterExpThumbUp = "点赞";
	builtinInterExpBomb = "炸弹";
	builtinInterExpEgg = "鸡蛋";
	builtinInterExpSlipper = "拖鞋";
    interExpCurrentCoin = "前金: %d金";
    interExpPropName = "道具: %s表情(%d)";
    interExpPrice = "r格: %d金";
    roomInterExpError = "玩家已x_房g，o法使用互颖砬";
    roomInterExpMeToOther = "你ν婕%s使用了%s";
    roomInterExpOtherToMe = "玩家%sδ闶褂昧%s";
    roomInterExpOtherToAnother = "玩家%sν婕%s使用了%s";
    roomInterExpDownloadAndUnzipSuccess = "恭喜您，新的互颖砬赢已下d完成";
    roomInterExpUnzipError = "很z憾，互颖砬榘解菏";
    roomInterExpDownloadOtherError = "很z憾，下d互颖砬槭";
    roomInterExpDownloadNetworkError = "很z憾，Wje`，下d互颖砬槭";
    roomInterExpDownloadFileIOError = "很z憾，文件xe`，下d互颖砬槭";
    roomInterExpDownloadNoSdcardError = "很z憾。SD卡未加d，下d互颖砬槭";
    roomCanNotBuyInterExp = "金派凫断孪蓿o法I";
    interExpNeedToDownloadTip = "您需要下d表情Y包後才可以使用哦，F在下d幔";
    interExpBuy = "I";
    interExpNotDownloaded = "未下d";
    interExpDownloading = "正在下d";
    buy_inter_exp_dialog_layout_okBtnTx = "I";
    buy_inter_exp_dialog_layout_cancelBtnTx = "取消";
    buy_inter_exp_dialog_layout_noRemindText = "不再提示";
    buy_inter_exp_dialog_layout_title_text = "表情盗坎蛔";
    interExpBuying = "正在I...";
    interExp = "互颖砬";
	-- add by lihuaping, end, 2013-12-09

    -- 串号检测 start
    invalidAccountMsg = "很抱歉，系yo法@取您的手CRea造成您的舸，到%s仍试S博雅斗地主@取嘞藜纯山Q}。";
    reason360Security = "360手Cl士";
    reasonLBESecurity = "LBE安全大或授喙芾";
    -- 串号检测 end

    hall_enterpwd_et_str = [[私人房密a]];

    exitTipRewardStr_m = "老大,今日未I取您%s金排叮";
    exitTipRewardStr_w = "小主,今日未I取您%s金排叮";
    exitTaskTipsText = "神秘箱";
    exitActivityTipsText = "精彩活";

    exitTipTomorrowRewardStr_m = "老大,明日再矸钏湍%s金眩";
    exitTipTomorrowRewardStr_w = "小主,明日再矸钏湍%s金眩";
    exitTipRewardDefaultStr = "H鄣,明日前奉上更多金排!";
	exitTipDoPlayStr = "立即去做>>";
    exitTipDoGetStr  = "立即去I>>";
    exitTaskScheduleTip = "完成M度：";
	exitUpdateVersionText = "版本更新";
    exitGoOnGameText = "^m[";
    exitQuitGameText = "退出[";

    roomChestCannotOpenTipStr = "客官,您的任者M度尚未_成,箱何茨荛_";

    paySelectStr = "加";

    mediaUnmounted = "SD卡已被卸d，部份[可能o法x取";

    privateChestNotice = "三人,]子,四人,比霾彭E_箱！";

    roomChestFinishStr = "_箱,A物";
    roomChestNotFinishStr = "剩%d局,_箱";

    version_download_completed = "博雅斗地主新版本下d成功，是否更新?";
    version_downloading = "下d更新中..";
	version_download_error = "下d出e";
	version_download_title = "更新提示";
	version_download_title2 = "博雅斗地主更新至最新版本，等你眢w!s快下d更新吧!";
	version_update_now = "立即更新";
	version_update_later = "以後再f";
	version_install_now = "立即安b";
	version_exit_game = "退出[";

	room_chest_tip_str = [[在任意龃未M%s局，即可_箱，@得元/M唬Q物！更有大量金诺砟茫]];
	room_chest_tip_activity_str = [[任意龃未M%d局，即可_箱；活悠陂g，罘倍！so泶蚺瓢桑]];
	room_chest_tip_text = [[任意龃未M%d局，即可_箱！]];
	room_chest_lottery_titile = [[恭喜您@得]];
	room_chest_lottery_activity_titile = [[活悠陂g罘倍，恭喜您@得]];
	room_bottom_chest_open = [[_箱 A物]];
	room_bottom_chest_activity_open = [[_箱 p倍]];
	room_bottom_chest_play = [[剩%d局  _箱]];

	trumpet_broadcast = "使用小喇叭可以l送全服V播";
	general_face = "常用表情";
	VIP_face = "VIP表情";
	daily_words = "常用Z";
	chat_record = "聊天";
	download_face_text = "下d 200K";
	downloading_text = "下d中..0%";
    downloadingStr = "下d中..";
	download_error = "下d失";
	download_netError = "下d失败，Wjl生常";
	download_fileIOerror = "下d失败，手C却娌蛔";
	download_sdcardError = "下d失败，手Csdcard未插";
	unzip_erro = "解菏";

	--高手选拔赛 赌神争霸赛
	ddz3MatchStrGao = "高手x拔";
	ddz3MatchStrDushen = "神霸";

    ddz3MatchStrDesc = "倒r %s   期e分%d   第%d名";

    morePayMethods = "更多支付";


	inputFriendcode = [[入好友邀a]];
	friendBindSucc = [[定成功，即可@得]];
	coins = [[1000金]];
	invaiteCodeError = [[邀a不存在，查看入是否正_]];
	bindNow = [[立即定]];
	
    --帮助界面描述用语
    helpTitle_1     = "r民地主二打一，哪出完哪A";
    helpContent_1_1 = "2r民合力打1地主，先出完牌的玩家";
    helpContent_1_2 = "在一方@伲r民任意一人出完牌，扇硕极@";
    helpContent_1_3 = "地主的人可以~外@得3底牌并先出牌";

    helpTitle_2     = "花色不重要，c当却笮";
    helpContent_2_1 = "出牌r，只比c荡笮。不比花色！";
    helpContent_2_2 = "EX：大王＞小王＞2＞A＞K＞Q＞J＞10＞9＞8＞7＞6＞5＞4＞3";

    helpTitle_3     = "火箭Sr海炸炸_花";
    helpContent_3_1 = "火箭：鬼牌一起出，檫[蜃畲笈菩停可以核有牌型";
    helpContent_3_2 = "炸：四一狱c档呐檎，非火箭牌型均可";

    helpTitle_4     = "三ο噙B成BΓ@映雠婆艿每";
    helpContent_4_1 = "只要有三B在一起的ψ樱就能一起出牌";
    helpContent_4_2 = "有三Bσ陨系呐疲不管Χ伎梢酝rBΤ";

    helpTitle_5     = "子最少出5，最L子3到A";
    helpContent_5_1 = "子3_始，但不能包括2，最少要出5";

    helpTitle_6     = "三l可以出，一，一Χ寄";
    helpContent_6_1 = "三一拥呐瞥槿l，可以一起出";
    helpContent_6_2 = "“三б弧保就是三牌加上一闻";
    helpContent_6_3 = "“三Ф”，就是三牌上一ε疲也就是葫J啦";

    helpTitle_7     = "三+三，wC出牌快快快";
    helpContent_7_1 = "wC：2M以上Bm底值娜";
    helpContent_7_2 = "wCА靶∫怼保山M以上的Bm三б";
    helpContent_7_3 = "wCА按笠怼保山M以上的Bm三Ф";

    helpTitle_8     = "c2只比鬼低，不能⑴c子，B及wC";
    helpContent_8_1 = "2是高牌，c抵槐裙淼停不能⑴c子，B及wC";
    helpContent_8_2 = "除火箭炸外，其他牌必要按牌型相同切迪嗤才能比大小";
};

return string_localize;